AAAACACGGTAGAGATAAGC -> AAACACGGTAGAGATAAGCT
AAAAGACATGGTCGAGTCCC -> AAAGACATGGTCGAGTCCCA
AAAAGGGTCAGGGCAAAGGA -> AAAGGGTCAGGGCAAAGGAG
AAACACGGTAGAGATAAGCT -> AACACGGTAGAGATAAGCTA
AAACAGTTTTGTTACCGAAC -> AACAGTTTTGTTACCGAACC
AAACATGTGTTAGCCGTTGC -> AACATGTGTTAGCCGTTGCA
AAACGTGGACAGTAGCGTTT -> AACGTGGACAGTAGCGTTTA
AAACGTTGGGAGATTGGGGA -> AACGTTGGGAGATTGGGGAG
AAAGACATGGTCGAGTCCCA -> AAGACATGGTCGAGTCCCAG
AAAGGAGTCACGCGCGTGGT -> AAGGAGTCACGCGCGTGGTC
AAAGGGTCAGGGCAAAGGAG -> AAGGGTCAGGGCAAAGGAGT
AAAGGTCCCGAGACTGAACG -> AAGGTCCCGAGACTGAACGG
AAATGCCTTAAGCGTCATGT -> AATGCCTTAAGCGTCATGTT
AAATGTATGCCGTCTTCTAG -> AATGTATGCCGTCTTCTAGG
AAATGTGAGTTGGCAAAAGG -> AATGTGAGTTGGCAAAAGGG
AAATTACCTGAAGGAACACG -> AATTACCTGAAGGAACACGC
AAATTCTGTGGCTGTGCAGG -> AATTCTGTGGCTGTGCAGGC
AACAACCGCCATCTCGGATA -> ACAACCGCCATCTCGGATAG
AACAAGATCATCCGTACAGG -> ACAAGATCATCCGTACAGGC
AACACGCTTAGGACAAATGT -> ACACGCTTAGGACAAATGTG
AACACGGTAGAGATAAGCTA -> ACACGGTAGAGATAAGCTAC
AACAGTTTTGTTACCGAACC -> ACAGTTTTGTTACCGAACCT
AACATGTGTTAGCCGTTGCA -> ACATGTGTTAGCCGTTGCAT
AACCACGCCCTAAACGTGGA -> ACCACGCCCTAAACGTGGAC
AACCGCCATCTCGGATAGTA -> ACCGCCATCTCGGATAGTAA
AACCTGGGAGTTTCAGAGTG -> ACCTGGGAGTTTCAGAGTGC
AACCTTGACGCAGAATGATT -> ACCTTGACGCAGAATGATTA
AACGCTAAGCGAGACATCGT -> ACGCTAAGCGAGACATCGTT
AACGGCGTCAATCCGCGATT -> ACGGCGTCAATCCGCGATTG
AACGGTCCTTAGGTCGGCAG -> ACGGTCCTTAGGTCGGCAGT
AACGTGGACAGTAGCGTTTA -> ACGTGGACAGTAGCGTTTAT
AACGTTGGGAGATTGGGGAG -> ACGTTGGGAGATTGGGGAGT
AACTGAGTCCACAAGTTAGG -> ACTGAGTCCACAAGTTAGGC
AAGAATTTTGTCCACCATGG -> AGAATTTTGTCCACCATGGG
AAGACATGGTCGAGTCCCAG -> AGACATGGTCGAGTCCCAGG
AAGACTTGCGTCATGAAAGG -> AGACTTGCGTCATGAAAGGT
AAGAGCAAACGTTGGGAGAT -> AGAGCAAACGTTGGGAGATT
AAGATACAAATGCCTTAAGC -> AGATACAAATGCCTTAAGCG
AAGATCATCCGTACAGGCAT -> AGATCATCCGTACAGGCATA
AAGCATCGCGTCACTGTCAG -> AGCATCGCGTCACTGTCAGG
AAGCGAGACATCGTTCTGTG -> AGCGAGACATCGTTCTGTGT
AAGCGTCATGTTCAGTTTTA -> AGCGTCATGTTCAGTTTTAA
AAGCTACTTAAATTCTGTGG -> AGCTACTTAAATTCTGTGGC
AAGCTCCATATAGACATAGA -> AGCTCCATATAGACATAGAA
AAGGAACACGCTTAGGACAA -> AGGAACACGCTTAGGACAAA
AAGGAGCTGTCAAGACTTGC -> AGGAGCTGTCAAGACTTGCG
AAGGAGTCACGCGCGTGGTC -> AGGAGTCACGCGCGTGGTCT
AAGGGGCTCTCTACACATGA -> AGGGGCTCTCTACACATGAA
AAGGGTCAGGGCAAAGGAGT -> AGGGTCAGGGCAAAGGAGTC
AAGGTCCCGAGACTGAACGG -> AGGTCCCGAGACTGAACGGC
AAGTAAATGTATGCCGTCTT -> AGTAAATGTATGCCGTCTTC
AAGTACTAAGATACAAATGC -> AGTACTAAGATACAAATGCC
AAGTACTACAAGAATTTTGT -> AGTACTACAAGAATTTTGTC
AAGTCATATACGCCACGTCC -> AGTCATATACGCCACGTCCG
AAGTCGGGGTAACCACGCCC -> AGTCGGGGTAACCACGCCCT
AAGTTAGGCGAGCAATCTAT -> AGTTAGGCGAGCAATCTATT
AATCCCGAAGCATCGCGTCA -> ATCCCGAAGCATCGCGTCAC
AATCCGCGATTGGTCTGATC -> ATCCGCGATTGGTCTGATCA
AATCTATTTGTCTACGCGTC -> ATCTATTTGTCTACGCGTCT
AATGATTATCAGTCCTATAC -> ATGATTATCAGTCCTATACT
AATGCCTTAAGCGTCATGTT -> ATGCCTTAAGCGTCATGTTC
AATGCGGTTAGCTCTTTCCC -> ATGCGGTTAGCTCTTTCCCA
AATGTATGCCGTCTTCTAGG -> ATGTATGCCGTCTTCTAGGC
AATGTGAGTTGGCAAAAGGG -> ATGTGAGTTGGCAAAAGGGT
AATTACCTGAAGGAACACGC -> ATTACCTGAAGGAACACGCT
AATTACGAAGTACTACAAGA -> ATTACGAAGTACTACAAGAA
AATTCTGTGGCTGTGCAGGC -> ATTCTGTGGCTGTGCAGGCA
AATTTTGTCCACCATGGGGT -> ATTTTGTCCACCATGGGGTC
ACAAATGCCTTAAGCGTCAT -> CAAATGCCTTAAGCGTCATG
ACAAATGTGAGTTGGCAAAA -> CAAATGTGAGTTGGCAAAAG
ACAACCGCCATCTCGGATAG -> CAACCGCCATCTCGGATAGT
ACAAGAATTTTGTCCACCAT -> CAAGAATTTTGTCCACCATG
ACAAGATCATCCGTACAGGC -> CAAGATCATCCGTACAGGCA
ACAAGGGGCTCTCTACACAT -> CAAGGGGCTCTCTACACATG
ACAAGTTAGGCGAGCAATCT -> CAAGTTAGGCGAGCAATCTA
ACACATGAACGGTCCTTAGG -> CACATGAACGGTCCTTAGGT
ACACGAGGTCCGTCATAAAA -> CACGAGGTCCGTCATAAAAG
ACACGCTTAGGACAAATGTG -> CACGCTTAGGACAAATGTGA
ACACGGTAGAGATAAGCTAC -> CACGGTAGAGATAAGCTACT
ACAGGCATACTGCAGGTTTT -> CAGGCATACTGCAGGTTTTC
ACAGTAGCGTTTATGTATTT -> CAGTAGCGTTTATGTATTTC
ACAGTTTTGTTACCGAACCT -> CAGTTTTGTTACCGAACCTG
ACATAGAATGCGGTTAGCTC -> CATAGAATGCGGTTAGCTCT
ACATCGTTCTGTGTACTAAG -> CATCGTTCTGTGTACTAAGT
ACATGAACGGTCCTTAGGTC -> CATGAACGGTCCTTAGGTCG
ACATGGTCGAGTCCCAGGCA -> CATGGTCGAGTCCCAGGCAG
ACATGTGTTAGCCGTTGCAT -> CATGTGTTAGCCGTTGCATA
ACCAATTACGAAGTACTACA -> CCAATTACGAAGTACTACAA
ACCACGCCCTAAACGTGGAC -> CCACGCCCTAAACGTGGACA
ACCATGGGGTCGGGAACTGA -> CCATGGGGTCGGGAACTGAG
ACCGAACCTGGGAGTTTCAG -> CCGAACCTGGGAGTTTCAGA
ACCGCCATCTCGGATAGTAA -> CCGCCATCTCGGATAGTAAA
ACCTCATGACCAATTACGAA -> CCTCATGACCAATTACGAAG
ACCTGAAGGAACACGCTTAG -> CCTGAAGGAACACGCTTAGG
ACCTGGGAGTTTCAGAGTGC -> CCTGGGAGTTTCAGAGTGCG
ACCTTACTCTTACGCTCGCT -> CCTTACTCTTACGCTCGCTC
ACCTTGACGCAGAATGATTA -> CCTTGACGCAGAATGATTAT
ACGAAGTACTACAAGAATTT -> CGAAGTACTACAAGAATTTT
ACGAGGTCCGTCATAAAAGA -> CGAGGTCCGTCATAAAAGAC
ACGCAGAATGATTATCAGTC -> CGCAGAATGATTATCAGTCC
ACGCCACGTCCGGGTTGATT -> CGCCACGTCCGGGTTGATTG
ACGCCCTAAACGTGGACAGT -> CGCCCTAAACGTGGACAGTA
ACGCGCGTGGTCTAGTACGG -> CGCGCGTGGTCTAGTACGGG
ACGCGTCTGTAACAAGATCA -> CGCGTCTGTAACAAGATCAT
ACGCTAAGCGAGACATCGTT -> CGCTAAGCGAGACATCGTTC
ACGCTCGCTCAAGCTCCATA -> CGCTCGCTCAAGCTCCATAT
ACGCTTAGGACAAATGTGAG -> CGCTTAGGACAAATGTGAGT
ACGGCGTCAATCCGCGATTG -> CGGCGTCAATCCGCGATTGG
ACGGGATTACCTTACTCTTA -> CGGGATTACCTTACTCTTAC
ACGGGCGTCCCAACCTTGAC -> CGGGCGTCCCAACCTTGACG
ACGGTAGAGATAAGCTACTT -> CGGTAGAGATAAGCTACTTA
ACGGTCCTTAGGTCGGCAGT -> CGGTCCTTAGGTCGGCAGTG
ACGGTCTCACCTCATGACCA -> CGGTCTCACCTCATGACCAA
ACGTCCGGGTTGATTGGGGT -> CGTCCGGGTTGATTGGGGTG
ACGTCGTCATGAGCCGTAGT -> CGTCGTCATGAGCCGTAGTT
ACGTGGACAGTAGCGTTTAT -> CGTGGACAGTAGCGTTTATG
ACGTTGGGAGATTGGGGAGT -> CGTTGGGAGATTGGGGAGTT
ACTAAGATACAAATGCCTTA -> CTAAGATACAAATGCCTTAA
ACTAAGTACTAAGATACAAA -> CTAAGTACTAAGATACAAAT
ACTACAAGAATTTTGTCCAC -> CTACAAGAATTTTGTCCACC
ACTCACACGAGGTCCGTCAT -> CTCACACGAGGTCCGTCATA
ACTCAGATAAGAGCAAACGT -> CTCAGATAAGAGCAAACGTT
ACTCTTACGCTCGCTCAAGC -> CTCTTACGCTCGCTCAAGCT
ACTGAACGGCGTCAATCCGC -> CTGAACGGCGTCAATCCGCG
ACTGAGTCCACAAGTTAGGC -> CTGAGTCCACAAGTTAGGCG
ACTGCAGGTTTTCGGAGCTC -> CTGCAGGTTTTCGGAGCTCG
ACTGCTGACAAGGGGCTCTC -> CTGCTGACAAGGGGCTCTCT
ACTGTCAGGAGCAAACATGT -> CTGTCAGGAGCAAACATGTG
ACTTAAATTCTGTGGCTGTG -> CTTAAATTCTGTGGCTGTGC
ACTTGCGTCATGAAAGGTCC -> CTTGCGTCATGAAAGGTCCC
AGAATGATTATCAGTCCTAT -> GAATGATTATCAGTCCTATA
AGAATGCGGTTAGCTCTTTC -> GAATGCGGTTAGCTCTTTCC
AGAATTTTGTCCACCATGGG -> GAATTTTGTCCACCATGGGG
AGACATAGAATGCGGTTAGC -> GACATAGAATGCGGTTAGCT
AGACATCGTTCTGTGTACTA -> GACATCGTTCTGTGTACTAA
AGACATGGTCGAGTCCCAGG -> GACATGGTCGAGTCCCAGGC
AGACTGAACGGCGTCAATCC -> GACTGAACGGCGTCAATCCG
AGACTTGCGTCATGAAAGGT -> GACTTGCGTCATGAAAGGTC
AGAGATAAGCTACTTAAATT -> GAGATAAGCTACTTAAATTC
AGAGCAAACGTTGGGAGATT -> GAGCAAACGTTGGGAGATTG
AGAGTGCGGCACGGGCGTCC -> GAGTGCGGCACGGGCGTCCC
AGATAAGAGCAAACGTTGGG -> GATAAGAGCAAACGTTGGGA
AGATAAGCTACTTAAATTCT -> GATAAGCTACTTAAATTCTG
AGATACAAATGCCTTAAGCG -> GATACAAATGCCTTAAGCGT
AGATCATCCGTACAGGCATA -> GATCATCCGTACAGGCATAC
AGATTGGGGAGTTTACGGTC -> GATTGGGGAGTTTACGGTCT
AGCAAACATGTGTTAGCCGT -> GCAAACATGTGTTAGCCGTT
AGCAAACGTTGGGAGATTGG -> GCAAACGTTGGGAGATTGGG
AGCAATCTATTTGTCTACGC -> GCAATCTATTTGTCTACGCG
AGCATCGCGTCACTGTCAGG -> GCATCGCGTCACTGTCAGGA
AGCCCAACAACCGCCATCTC -> GCCCAACAACCGCCATCTCG
AGCCGTAGTTCAACGCTAAG -> GCCGTAGTTCAACGCTAAGC
AGCCGTTCTCGCAAAACACG -> GCCGTTCTCGCAAAACACGG
AGCCGTTGCATAAGTAAATG -> GCCGTTGCATAAGTAAATGT
AGCGAGACATCGTTCTGTGT -> GCGAGACATCGTTCTGTGTA
AGCGTCATGTTCAGTTTTAA -> GCGTCATGTTCAGTTTTAAG
AGCGTTTATGTATTTCTCAG -> GCGTTTATGTATTTCTCAGA
AGCTACTTAAATTCTGTGGC -> GCTACTTAAATTCTGTGGCT
AGCTCCATATAGACATAGAA -> GCTCCATATAGACATAGAAT
AGCTCGGCTCTGTCCACGTC -> GCTCGGCTCTGTCCACGTCG
AGCTCTTTCCCAGCCGTTCT -> GCTCTTTCCCAGCCGTTCTC
AGCTGTCAAGACTTGCGTCA -> GCTGTCAAGACTTGCGTCAT
AGGAACACGCTTAGGACAAA -> GGAACACGCTTAGGACAAAT
AGGACAAATGTGAGTTGGCA -> GGACAAATGTGAGTTGGCAA
AGGAGCAAACATGTGTTAGC -> GGAGCAAACATGTGTTAGCC
AGGAGCTGTCAAGACTTGCG -> GGAGCTGTCAAGACTTGCGT
AGGAGTCACGCGCGTGGTCT -> GGAGTCACGCGCGTGGTCTA
AGGCAGGGACTCAGATAAGA -> GGCAGGGACTCAGATAAGAG
AGGCAGTATGCCCTCAATCC -> GGCAGTATGCCCTCAATCCC
AGGCATACTGCAGGTTTTCG -> GGCATACTGCAGGTTTTCGG
AGGCATGGGCGACTGCTGAC -> GGCATGGGCGACTGCTGACA
AGGCGAGCAATCTATTTGTC -> GGCGAGCAATCTATTTGTCT
AGGGACTCAGATAAGAGCAA -> GGGACTCAGATAAGAGCAAA
AGGGCAAAGGAGTCACGCGC -> GGGCAAAGGAGTCACGCGCG
AGGGGCTCTCTACACATGAA -> GGGGCTCTCTACACATGAAC
AGGGTCAGGGCAAAGGAGTC -> GGGTCAGGGCAAAGGAGTCA
AGGTCCCGAGACTGAACGGC -> GGTCCCGAGACTGAACGGCG
AGGTCCGTCATAAAAGACAT -> GGTCCGTCATAAAAGACATG
AGGTCGGCAGTGGGCCTCTA -> GGTCGGCAGTGGGCCTCTAA
AGGTTTTCGGAGCTCGGCTC -> GGTTTTCGGAGCTCGGCTCT
AGTAAATGTATGCCGTCTTC -> GTAAATGTATGCCGTCTTCT
AGTAAATTACCTGAAGGAAC -> GTAAATTACCTGAAGGAACA
AGTACGGGATTACCTTACTC -> GTACGGGATTACCTTACTCT
AGTACTAAGATACAAATGCC -> GTACTAAGATACAAATGCCT
AGTACTACAAGAATTTTGTC -> GTACTACAAGAATTTTGTCC
AGTAGCGTTTATGTATTTCT -> GTAGCGTTTATGTATTTCTC
AGTATGCCCTCAATCCCGAA -> GTATGCCCTCAATCCCGAAG
AGTCACGCGCGTGGTCTAGT -> GTCACGCGCGTGGTCTAGTA
AGTCATATACGCCACGTCCG -> GTCATATACGCCACGTCCGG
AGTCCACAAGTTAGGCGAGC -> GTCCACAAGTTAGGCGAGCA
AGTCCCAGGCAGGGACTCAG -> GTCCCAGGCAGGGACTCAGA
AGTCCTATACTCACACGAGG -> GTCCTATACTCACACGAGGT
AGTCGGGGTAACCACGCCCT -> GTCGGGGTAACCACGCCCTA
AGTGCGGCACGGGCGTCCCA -> GTGCGGCACGGGCGTCCCAA
AGTGGGCCTCTAAGTCGGGG -> GTGGGCCTCTAAGTCGGGGT
AGTTAGGCGAGCAATCTATT -> GTTAGGCGAGCAATCTATTT
AGTTCAACGCTAAGCGAGAC -> GTTCAACGCTAAGCGAGACA
AGTTGGCAAAAGGGTCAGGG -> GTTGGCAAAAGGGTCAGGGC
AGTTTACGGTCTCACCTCAT -> GTTTACGGTCTCACCTCATG
AGTTTCAGAGTGCGGCACGG -> GTTTCAGAGTGCGGCACGGG
AGTTTTAAGGAGCTGTCAAG -> GTTTTAAGGAGCTGTCAAGA
AGTTTTGTTACCGAACCTGG -> GTTTTGTTACCGAACCTGGG
ATAAAAGACATGGTCGAGTC -> TAAAAGACATGGTCGAGTCC
ATAAGAGCAAACGTTGGGAG -> TAAGAGCAAACGTTGGGAGA
ATAAGCTACTTAAATTCTGT -> TAAGCTACTTAAATTCTGTG
ATAAGTAAATGTATGCCGTC -> TAAGTAAATGTATGCCGTCT
ATACAAATGCCTTAAGCGTC -> TACAAATGCCTTAAGCGTCA
ATACGCCACGTCCGGGTTGA -> TACGCCACGTCCGGGTTGAT
ATACTCACACGAGGTCCGTC -> TACTCACACGAGGTCCGTCA
ATACTGCAGGTTTTCGGAGC -> TACTGCAGGTTTTCGGAGCT
ATAGAATGCGGTTAGCTCTT -> TAGAATGCGGTTAGCTCTTT
ATAGACATAGAATGCGGTTA -> TAGACATAGAATGCGGTTAG
ATAGTAAATTACCTGAAGGA -> TAGTAAATTACCTGAAGGAA
ATATACGCCACGTCCGGGTT -> TATACGCCACGTCCGGGTTG
ATATAGACATAGAATGCGGT -> TATAGACATAGAATGCGGTT
ATATGTAGCCCAACAACCGC -> TATGTAGCCCAACAACCGCC
ATCAAGTCATATACGCCACG -> TCAAGTCATATACGCCACGT
ATCAGTCCTATACTCACACG -> TCAGTCCTATACTCACACGA
ATCATCCGTACAGGCATACT -> TCATCCGTACAGGCATACTG
ATCCCGAAGCATCGCGTCAC -> TCCCGAAGCATCGCGTCACT
ATCCGCGATTGGTCTGATCA -> TCCGCGATTGGTCTGATCAA
ATCCGTACAGGCATACTGCA -> TCCGTACAGGCATACTGCAG
ATCGCGTCACTGTCAGGAGC -> TCGCGTCACTGTCAGGAGCA
ATCGTTCTGTGTACTAAGTA -> TCGTTCTGTGTACTAAGTAC
ATCTATTTGTCTACGCGTCT -> TCTATTTGTCTACGCGTCTG
ATCTCGGATAGTAAATTACC -> TCTCGGATAGTAAATTACCT
ATGAAAGGTCCCGAGACTGA -> TGAAAGGTCCCGAGACTGAA
ATGAACGGTCCTTAGGTCGG -> TGAACGGTCCTTAGGTCGGC
ATGACCAATTACGAAGTACT -> TGACCAATTACGAAGTACTA
ATGAGCCGTAGTTCAACGCT -> TGAGCCGTAGTTCAACGCTA
ATGATTATCAGTCCTATACT -> TGATTATCAGTCCTATACTC
ATGCCCTCAATCCCGAAGCA -> TGCCCTCAATCCCGAAGCAT
ATGCCGTCTTCTAGGCATGG -> TGCCGTCTTCTAGGCATGGG
ATGCCTTAAGCGTCATGTTC -> TGCCTTAAGCGTCATGTTCA
ATGCGGTTAGCTCTTTCCCA -> TGCGGTTAGCTCTTTCCCAG
ATGGGCGACTGCTGACAAGG -> TGGGCGACTGCTGACAAGGG
ATGGGGTCGGGAACTGAGTC -> TGGGGTCGGGAACTGAGTCC
ATGGTCGAGTCCCAGGCAGG -> TGGTCGAGTCCCAGGCAGGG
ATGTAGCCCAACAACCGCCA -> TGTAGCCCAACAACCGCCAT
ATGTATGCCGTCTTCTAGGC -> TGTATGCCGTCTTCTAGGCA
ATGTATTTCTCAGACGAAAG -> TGTATTTCTCAGACGAAAGA
ATGTGAGTTGGCAAAAGGGT -> TGTGAGTTGGCAAAAGGGTC
ATGTGTTAGCCGTTGCATAA -> TGTGTTAGCCGTTGCATAAG
ATGTTCAGTTTTAAGGAGCT -> TGTTCAGTTTTAAGGAGCTG
ATTACCTGAAGGAACACGCT -> TTACCTGAAGGAACACGCTT
ATTACCTTACTCTTACGCTC -> TTACCTTACTCTTACGCTCG
ATTACGAAGTACTACAAGAA -> TTACGAAGTACTACAAGAAT
ATTATCAGTCCTATACTCAC -> TTATCAGTCCTATACTCACA
ATTCTGTGGCTGTGCAGGCA -> TTCTGTGGCTGTGCAGGCAG
ATTGGGGAGTTTACGGTCTC -> TTGGGGAGTTTACGGTCTCA
ATTGGGGTGTGCTGATATGT -> TTGGGGTGTGCTGATATGTA
ATTGGTCTGATCAAGTCATA -> TTGGTCTGATCAAGTCATAT
ATTTCTCAGACGAAAGACTC -> TTTCTCAGACGAAAGACTCA
ATTTGTCTACGCGTCTGTAA -> TTTGTCTACGCGTCTGTAAC
ATTTTGTCCACCATGGGGTC -> TTTTGTCCACCATGGGGTCG
CAAAACACGGTAGAGATAAG -> AAAACACGGTAGAGATAAGC
CAAAAGGGTCAGGGCAAAGG -> AAAAGGGTCAGGGCAAAGGA
CAAACATGTGTTAGCCGTTG -> AAACATGTGTTAGCCGTTGC
CAAACGTTGGGAGATTGGGG -> AAACGTTGGGAGATTGGGGA
CAAAGGAGTCACGCGCGTGG -> AAAGGAGTCACGCGCGTGGT
CAAATGCCTTAAGCGTCATG -> AAATGCCTTAAGCGTCATGT
CAAATGTGAGTTGGCAAAAG -> AAATGTGAGTTGGCAAAAGG
CAACAACCGCCATCTCGGAT -> AACAACCGCCATCTCGGATA
CAACCGCCATCTCGGATAGT -> AACCGCCATCTCGGATAGTA
CAACCTTGACGCAGAATGAT -> AACCTTGACGCAGAATGATT
CAACGCTAAGCGAGACATCG -> AACGCTAAGCGAGACATCGT
CAAGAATTTTGTCCACCATG -> AAGAATTTTGTCCACCATGG
CAAGACTTGCGTCATGAAAG -> AAGACTTGCGTCATGAAAGG
CAAGATCATCCGTACAGGCA -> AAGATCATCCGTACAGGCAT
CAAGCTCCATATAGACATAG -> AAGCTCCATATAGACATAGA
CAAGGGGCTCTCTACACATG -> AAGGGGCTCTCTACACATGA
CAAGTCATATACGCCACGTC -> AAGTCATATACGCCACGTCC
CAAGTTAGGCGAGCAATCTA -> AAGTTAGGCGAGCAATCTAT
CAATCCCGAAGCATCGCGTC -> AATCCCGAAGCATCGCGTCA
CAATCCGCGATTGGTCTGAT -> AATCCGCGATTGGTCTGATC
CAATCTATTTGTCTACGCGT -> AATCTATTTGTCTACGCGTC
CAATTACGAAGTACTACAAG -> AATTACGAAGTACTACAAGA
CACAAGTTAGGCGAGCAATC -> ACAAGTTAGGCGAGCAATCT
CACACGAGGTCCGTCATAAA -> ACACGAGGTCCGTCATAAAA
CACATGAACGGTCCTTAGGT -> ACATGAACGGTCCTTAGGTC
CACCATGGGGTCGGGAACTG -> ACCATGGGGTCGGGAACTGA
CACCTCATGACCAATTACGA -> ACCTCATGACCAATTACGAA
CACGAGGTCCGTCATAAAAG -> ACGAGGTCCGTCATAAAAGA
CACGCCCTAAACGTGGACAG -> ACGCCCTAAACGTGGACAGT
CACGCGCGTGGTCTAGTACG -> ACGCGCGTGGTCTAGTACGG
CACGCTTAGGACAAATGTGA -> ACGCTTAGGACAAATGTGAG
CACGGGCGTCCCAACCTTGA -> ACGGGCGTCCCAACCTTGAC
CACGGTAGAGATAAGCTACT -> ACGGTAGAGATAAGCTACTT
CACGTCCGGGTTGATTGGGG -> ACGTCCGGGTTGATTGGGGT
CACGTCGTCATGAGCCGTAG -> ACGTCGTCATGAGCCGTAGT
CACTGTCAGGAGCAAACATG -> ACTGTCAGGAGCAAACATGT
CAGAATGATTATCAGTCCTA -> AGAATGATTATCAGTCCTAT
CAGAGTGCGGCACGGGCGTC -> AGAGTGCGGCACGGGCGTCC
CAGATAAGAGCAAACGTTGG -> AGATAAGAGCAAACGTTGGG
CAGCCGTTCTCGCAAAACAC -> AGCCGTTCTCGCAAAACACG
CAGGAGCAAACATGTGTTAG -> AGGAGCAAACATGTGTTAGC
CAGGCAGGGACTCAGATAAG -> AGGCAGGGACTCAGATAAGA
CAGGCAGTATGCCCTCAATC -> AGGCAGTATGCCCTCAATCC
CAGGCATACTGCAGGTTTTC -> AGGCATACTGCAGGTTTTCG
CAGGGACTCAGATAAGAGCA -> AGGGACTCAGATAAGAGCAA
CAGGGCAAAGGAGTCACGCG -> AGGGCAAAGGAGTCACGCGC
CAGGTTTTCGGAGCTCGGCT -> AGGTTTTCGGAGCTCGGCTC
CAGTAGCGTTTATGTATTTC -> AGTAGCGTTTATGTATTTCT
CAGTATGCCCTCAATCCCGA -> AGTATGCCCTCAATCCCGAA
CAGTCCTATACTCACACGAG -> AGTCCTATACTCACACGAGG
CAGTGGGCCTCTAAGTCGGG -> AGTGGGCCTCTAAGTCGGGG
CAGTTTTAAGGAGCTGTCAA -> AGTTTTAAGGAGCTGTCAAG
CAGTTTTGTTACCGAACCTG -> AGTTTTGTTACCGAACCTGG
CATAAAAGACATGGTCGAGT -> ATAAAAGACATGGTCGAGTC
CATAAGTAAATGTATGCCGT -> ATAAGTAAATGTATGCCGTC
CATACTGCAGGTTTTCGGAG -> ATACTGCAGGTTTTCGGAGC
CATAGAATGCGGTTAGCTCT -> ATAGAATGCGGTTAGCTCTT
CATATACGCCACGTCCGGGT -> ATATACGCCACGTCCGGGTT
CATATAGACATAGAATGCGG -> ATATAGACATAGAATGCGGT
CATCCGTACAGGCATACTGC -> ATCCGTACAGGCATACTGCA
CATCGCGTCACTGTCAGGAG -> ATCGCGTCACTGTCAGGAGC
CATCGTTCTGTGTACTAAGT -> ATCGTTCTGTGTACTAAGTA
CATCTCGGATAGTAAATTAC -> ATCTCGGATAGTAAATTACC
CATGAAAGGTCCCGAGACTG -> ATGAAAGGTCCCGAGACTGA
CATGAACGGTCCTTAGGTCG -> ATGAACGGTCCTTAGGTCGG
CATGACCAATTACGAAGTAC -> ATGACCAATTACGAAGTACT
CATGAGCCGTAGTTCAACGC -> ATGAGCCGTAGTTCAACGCT
CATGGGCGACTGCTGACAAG -> ATGGGCGACTGCTGACAAGG
CATGGGGTCGGGAACTGAGT -> ATGGGGTCGGGAACTGAGTC
CATGGTCGAGTCCCAGGCAG -> ATGGTCGAGTCCCAGGCAGG
CATGTGTTAGCCGTTGCATA -> ATGTGTTAGCCGTTGCATAA
CATGTTCAGTTTTAAGGAGC -> ATGTTCAGTTTTAAGGAGCT
CCAACAACCGCCATCTCGGA -> CAACAACCGCCATCTCGGAT
CCAACCTTGACGCAGAATGA -> CAACCTTGACGCAGAATGAT
CCAATTACGAAGTACTACAA -> CAATTACGAAGTACTACAAG
CCACAAGTTAGGCGAGCAAT -> CACAAGTTAGGCGAGCAATC
CCACCATGGGGTCGGGAACT -> CACCATGGGGTCGGGAACTG
CCACGCCCTAAACGTGGACA -> CACGCCCTAAACGTGGACAG
CCACGTCCGGGTTGATTGGG -> CACGTCCGGGTTGATTGGGG
CCACGTCGTCATGAGCCGTA -> CACGTCGTCATGAGCCGTAG
CCAGCCGTTCTCGCAAAACA -> CAGCCGTTCTCGCAAAACAC
CCAGGCAGGGACTCAGATAA -> CAGGCAGGGACTCAGATAAG
CCATATAGACATAGAATGCG -> CATATAGACATAGAATGCGG
CCATCTCGGATAGTAAATTA -> CATCTCGGATAGTAAATTAC
CCATGGGGTCGGGAACTGAG -> CATGGGGTCGGGAACTGAGT
CCCAACAACCGCCATCTCGG -> CCAACAACCGCCATCTCGGA
CCCAACCTTGACGCAGAATG -> CCAACCTTGACGCAGAATGA
CCCAGCCGTTCTCGCAAAAC -> CCAGCCGTTCTCGCAAAACA
CCCAGGCAGGGACTCAGATA -> CCAGGCAGGGACTCAGATAA
CCCGAAGCATCGCGTCACTG -> CCGAAGCATCGCGTCACTGT
CCCGAGACTGAACGGCGTCA -> CCGAGACTGAACGGCGTCAA
CCCTAAACGTGGACAGTAGC -> CCTAAACGTGGACAGTAGCG
CCCTCAATCCCGAAGCATCG -> CCTCAATCCCGAAGCATCGC
CCGAACCTGGGAGTTTCAGA -> CGAACCTGGGAGTTTCAGAG
CCGAAGCATCGCGTCACTGT -> CGAAGCATCGCGTCACTGTC
CCGAGACTGAACGGCGTCAA -> CGAGACTGAACGGCGTCAAT
CCGCCATCTCGGATAGTAAA -> CGCCATCTCGGATAGTAAAT
CCGCGATTGGTCTGATCAAG -> CGCGATTGGTCTGATCAAGT
CCGGGTTGATTGGGGTGTGC -> CGGGTTGATTGGGGTGTGCT
CCGTACAGGCATACTGCAGG -> CGTACAGGCATACTGCAGGT
CCGTAGTTCAACGCTAAGCG -> CGTAGTTCAACGCTAAGCGA
CCGTCATAAAAGACATGGTC -> CGTCATAAAAGACATGGTCG
CCGTCTTCTAGGCATGGGCG -> CGTCTTCTAGGCATGGGCGA
CCGTTCTCGCAAAACACGGT -> CGTTCTCGCAAAACACGGTA
CCGTTGCATAAGTAAATGTA -> CGTTGCATAAGTAAATGTAT
CCTAAACGTGGACAGTAGCG -> CTAAACGTGGACAGTAGCGT
CCTATACTCACACGAGGTCC -> CTATACTCACACGAGGTCCG
CCTCAATCCCGAAGCATCGC -> CTCAATCCCGAAGCATCGCG
CCTCATGACCAATTACGAAG -> CTCATGACCAATTACGAAGT
CCTCTAAGTCGGGGTAACCA -> CTCTAAGTCGGGGTAACCAC
CCTGAAGGAACACGCTTAGG -> CTGAAGGAACACGCTTAGGA
CCTGGGAGTTTCAGAGTGCG -> CTGGGAGTTTCAGAGTGCGG
CCTTAAGCGTCATGTTCAGT -> CTTAAGCGTCATGTTCAGTT
CCTTACTCTTACGCTCGCTC -> CTTACTCTTACGCTCGCTCA
CCTTAGGTCGGCAGTGGGCC -> CTTAGGTCGGCAGTGGGCCT
CCTTGACGCAGAATGATTAT -> CTTGACGCAGAATGATTATC
CGAACCTGGGAGTTTCAGAG -> GAACCTGGGAGTTTCAGAGT
CGAAGCATCGCGTCACTGTC -> GAAGCATCGCGTCACTGTCA
CGAAGTACTACAAGAATTTT -> GAAGTACTACAAGAATTTTG
CGACTGCTGACAAGGGGCTC -> GACTGCTGACAAGGGGCTCT
CGAGACATCGTTCTGTGTAC -> GAGACATCGTTCTGTGTACT
CGAGACTGAACGGCGTCAAT -> GAGACTGAACGGCGTCAATC
CGAGCAATCTATTTGTCTAC -> GAGCAATCTATTTGTCTACG
CGAGGTCCGTCATAAAAGAC -> GAGGTCCGTCATAAAAGACA
CGAGTCCCAGGCAGGGACTC -> GAGTCCCAGGCAGGGACTCA
CGATTGGTCTGATCAAGTCA -> GATTGGTCTGATCAAGTCAT
CGCAAAACACGGTAGAGATA -> GCAAAACACGGTAGAGATAA
CGCAGAATGATTATCAGTCC -> GCAGAATGATTATCAGTCCT
CGCCACGTCCGGGTTGATTG -> GCCACGTCCGGGTTGATTGG
CGCCATCTCGGATAGTAAAT -> GCCATCTCGGATAGTAAATT
CGCCCTAAACGTGGACAGTA -> GCCCTAAACGTGGACAGTAG
CGCGATTGGTCTGATCAAGT -> GCGATTGGTCTGATCAAGTC
CGCGCGTGGTCTAGTACGGG -> GCGCGTGGTCTAGTACGGGA
CGCGTCACTGTCAGGAGCAA -> GCGTCACTGTCAGGAGCAAA
CGCGTCTGTAACAAGATCAT -> GCGTCTGTAACAAGATCATC
CGCGTGGTCTAGTACGGGAT -> GCGTGGTCTAGTACGGGATT
CGCTAAGCGAGACATCGTTC -> GCTAAGCGAGACATCGTTCT
CGCTCAAGCTCCATATAGAC -> GCTCAAGCTCCATATAGACA
CGCTCGCTCAAGCTCCATAT -> GCTCGCTCAAGCTCCATATA
CGCTTAGGACAAATGTGAGT -> GCTTAGGACAAATGTGAGTT
CGGAGCTCGGCTCTGTCCAC -> GGAGCTCGGCTCTGTCCACG
CGGATAGTAAATTACCTGAA -> GGATAGTAAATTACCTGAAG
CGGCACGGGCGTCCCAACCT -> GGCACGGGCGTCCCAACCTT
CGGCAGTGGGCCTCTAAGTC -> GGCAGTGGGCCTCTAAGTCG
CGGCGTCAATCCGCGATTGG -> GGCGTCAATCCGCGATTGGT
CGGCTCTGTCCACGTCGTCA -> GGCTCTGTCCACGTCGTCAT
CGGGAACTGAGTCCACAAGT -> GGGAACTGAGTCCACAAGTT
CGGGATTACCTTACTCTTAC -> GGGATTACCTTACTCTTACG
CGGGCGTCCCAACCTTGACG -> GGGCGTCCCAACCTTGACGC
CGGGGTAACCACGCCCTAAA -> GGGGTAACCACGCCCTAAAC
CGGGTTGATTGGGGTGTGCT -> GGGTTGATTGGGGTGTGCTG
CGGTAGAGATAAGCTACTTA -> GGTAGAGATAAGCTACTTAA
CGGTCCTTAGGTCGGCAGTG -> GGTCCTTAGGTCGGCAGTGG
CGGTCTCACCTCATGACCAA -> GGTCTCACCTCATGACCAAT
CGGTTAGCTCTTTCCCAGCC -> GGTTAGCTCTTTCCCAGCCG
CGTACAGGCATACTGCAGGT -> GTACAGGCATACTGCAGGTT
CGTAGTTCAACGCTAAGCGA -> GTAGTTCAACGCTAAGCGAG
CGTCAATCCGCGATTGGTCT -> GTCAATCCGCGATTGGTCTG
CGTCACTGTCAGGAGCAAAC -> GTCACTGTCAGGAGCAAACA
CGTCATAAAAGACATGGTCG -> GTCATAAAAGACATGGTCGA
CGTCATGAAAGGTCCCGAGA -> GTCATGAAAGGTCCCGAGAC
CGTCATGAGCCGTAGTTCAA -> GTCATGAGCCGTAGTTCAAC
CGTCATGTTCAGTTTTAAGG -> GTCATGTTCAGTTTTAAGGA
CGTCCCAACCTTGACGCAGA -> GTCCCAACCTTGACGCAGAA
CGTCCGGGTTGATTGGGGTG -> GTCCGGGTTGATTGGGGTGT
CGTCGTCATGAGCCGTAGTT -> GTCGTCATGAGCCGTAGTTC
CGTCTGTAACAAGATCATCC -> GTCTGTAACAAGATCATCCG
CGTCTTCTAGGCATGGGCGA -> GTCTTCTAGGCATGGGCGAC
CGTGGACAGTAGCGTTTATG -> GTGGACAGTAGCGTTTATGT
CGTGGTCTAGTACGGGATTA -> GTGGTCTAGTACGGGATTAC
CGTTCTCGCAAAACACGGTA -> GTTCTCGCAAAACACGGTAG
CGTTCTGTGTACTAAGTACT -> GTTCTGTGTACTAAGTACTA
CGTTGCATAAGTAAATGTAT -> GTTGCATAAGTAAATGTATG
CGTTGGGAGATTGGGGAGTT -> GTTGGGAGATTGGGGAGTTT
CGTTTATGTATTTCTCAGAC -> GTTTATGTATTTCTCAGACG
CTAAACGTGGACAGTAGCGT -> TAAACGTGGACAGTAGCGTT
CTAAGATACAAATGCCTTAA -> TAAGATACAAATGCCTTAAG
CTAAGCGAGACATCGTTCTG -> TAAGCGAGACATCGTTCTGT
CTAAGTACTAAGATACAAAT -> TAAGTACTAAGATACAAATG
CTAAGTCGGGGTAACCACGC -> TAAGTCGGGGTAACCACGCC
CTACAAGAATTTTGTCCACC -> TACAAGAATTTTGTCCACCA
CTACACATGAACGGTCCTTA -> TACACATGAACGGTCCTTAG
CTACGCGTCTGTAACAAGAT -> TACGCGTCTGTAACAAGATC
CTACTTAAATTCTGTGGCTG -> TACTTAAATTCTGTGGCTGT
CTAGGCATGGGCGACTGCTG -> TAGGCATGGGCGACTGCTGA
CTAGTACGGGATTACCTTAC -> TAGTACGGGATTACCTTACT
CTATACTCACACGAGGTCCG -> TATACTCACACGAGGTCCGT
CTATTTGTCTACGCGTCTGT -> TATTTGTCTACGCGTCTGTA
CTCAAGCTCCATATAGACAT -> TCAAGCTCCATATAGACATA
CTCAATCCCGAAGCATCGCG -> TCAATCCCGAAGCATCGCGT
CTCACACGAGGTCCGTCATA -> TCACACGAGGTCCGTCATAA
CTCACCTCATGACCAATTAC -> TCACCTCATGACCAATTACG
CTCAGATAAGAGCAAACGTT -> TCAGATAAGAGCAAACGTTG
CTCATGACCAATTACGAAGT -> TCATGACCAATTACGAAGTA
CTCCATATAGACATAGAATG -> TCCATATAGACATAGAATGC
CTCGCAAAACACGGTAGAGA -> TCGCAAAACACGGTAGAGAT
CTCGCTCAAGCTCCATATAG -> TCGCTCAAGCTCCATATAGA
CTCGGATAGTAAATTACCTG -> TCGGATAGTAAATTACCTGA
CTCGGCTCTGTCCACGTCGT -> TCGGCTCTGTCCACGTCGTC
CTCTAAGTCGGGGTAACCAC -> TCTAAGTCGGGGTAACCACG
CTCTACACATGAACGGTCCT -> TCTACACATGAACGGTCCTT
CTCTCTACACATGAACGGTC -> TCTCTACACATGAACGGTCC
CTCTGTCCACGTCGTCATGA -> TCTGTCCACGTCGTCATGAG
CTCTTACGCTCGCTCAAGCT -> TCTTACGCTCGCTCAAGCTC
CTCTTTCCCAGCCGTTCTCG -> TCTTTCCCAGCCGTTCTCGC
CTGAACGGCGTCAATCCGCG -> TGAACGGCGTCAATCCGCGA
CTGAAGGAACACGCTTAGGA -> TGAAGGAACACGCTTAGGAC
CTGACAAGGGGCTCTCTACA -> TGACAAGGGGCTCTCTACAC
CTGAGTCCACAAGTTAGGCG -> TGAGTCCACAAGTTAGGCGA
CTGATATGTAGCCCAACAAC -> TGATATGTAGCCCAACAACC
CTGATCAAGTCATATACGCC -> TGATCAAGTCATATACGCCA
CTGCAGGTTTTCGGAGCTCG -> TGCAGGTTTTCGGAGCTCGG
CTGCTGACAAGGGGCTCTCT -> TGCTGACAAGGGGCTCTCTA
CTGGGAGTTTCAGAGTGCGG -> TGGGAGTTTCAGAGTGCGGC
CTGTAACAAGATCATCCGTA -> TGTAACAAGATCATCCGTAC
CTGTCAAGACTTGCGTCATG -> TGTCAAGACTTGCGTCATGA
CTGTCAGGAGCAAACATGTG -> TGTCAGGAGCAAACATGTGT
CTGTCCACGTCGTCATGAGC -> TGTCCACGTCGTCATGAGCC
CTGTGCAGGCAGTATGCCCT -> TGTGCAGGCAGTATGCCCTC
CTGTGGCTGTGCAGGCAGTA -> TGTGGCTGTGCAGGCAGTAT
CTGTGTACTAAGTACTAAGA -> TGTGTACTAAGTACTAAGAT
CTTAAATTCTGTGGCTGTGC -> TTAAATTCTGTGGCTGTGCA
CTTAAGCGTCATGTTCAGTT -> TTAAGCGTCATGTTCAGTTT
CTTACGCTCGCTCAAGCTCC -> TTACGCTCGCTCAAGCTCCA
CTTACTCTTACGCTCGCTCA -> TTACTCTTACGCTCGCTCAA
CTTAGGACAAATGTGAGTTG -> TTAGGACAAATGTGAGTTGG
CTTAGGTCGGCAGTGGGCCT -> TTAGGTCGGCAGTGGGCCTC
CTTCTAGGCATGGGCGACTG -> TTCTAGGCATGGGCGACTGC
CTTGACGCAGAATGATTATC -> TTGACGCAGAATGATTATCA
CTTGCGTCATGAAAGGTCCC -> TTGCGTCATGAAAGGTCCCG
CTTTCCCAGCCGTTCTCGCA -> TTTCCCAGCCGTTCTCGCAA
GAAAGGTCCCGAGACTGAAC -> AAAGGTCCCGAGACTGAACG
GAACACGCTTAGGACAAATG -> AACACGCTTAGGACAAATGT
GAACCTGGGAGTTTCAGAGT -> AACCTGGGAGTTTCAGAGTG
GAACGGCGTCAATCCGCGAT -> AACGGCGTCAATCCGCGATT
GAACGGTCCTTAGGTCGGCA -> AACGGTCCTTAGGTCGGCAG
GAACTGAGTCCACAAGTTAG -> AACTGAGTCCACAAGTTAGG
GAAGCATCGCGTCACTGTCA -> AAGCATCGCGTCACTGTCAG
GAAGGAACACGCTTAGGACA -> AAGGAACACGCTTAGGACAA
GAAGTACTACAAGAATTTTG -> AAGTACTACAAGAATTTTGT
GAATGATTATCAGTCCTATA -> AATGATTATCAGTCCTATAC
GAATGCGGTTAGCTCTTTCC -> AATGCGGTTAGCTCTTTCCC
GAATTTTGTCCACCATGGGG -> AATTTTGTCCACCATGGGGT
GACAAATGTGAGTTGGCAAA -> ACAAATGTGAGTTGGCAAAA
GACAAGGGGCTCTCTACACA -> ACAAGGGGCTCTCTACACAT
GACAGTAGCGTTTATGTATT -> ACAGTAGCGTTTATGTATTT
GACATAGAATGCGGTTAGCT -> ACATAGAATGCGGTTAGCTC
GACATCGTTCTGTGTACTAA -> ACATCGTTCTGTGTACTAAG
GACATGGTCGAGTCCCAGGC -> ACATGGTCGAGTCCCAGGCA
GACCAATTACGAAGTACTAC -> ACCAATTACGAAGTACTACA
GACGCAGAATGATTATCAGT -> ACGCAGAATGATTATCAGTC
GACTCAGATAAGAGCAAACG -> ACTCAGATAAGAGCAAACGT
GACTGAACGGCGTCAATCCG -> ACTGAACGGCGTCAATCCGC
GACTGCTGACAAGGGGCTCT -> ACTGCTGACAAGGGGCTCTC
GACTTGCGTCATGAAAGGTC -> ACTTGCGTCATGAAAGGTCC
GAGACATCGTTCTGTGTACT -> AGACATCGTTCTGTGTACTA
GAGACTGAACGGCGTCAATC -> AGACTGAACGGCGTCAATCC
GAGATAAGCTACTTAAATTC -> AGATAAGCTACTTAAATTCT
GAGATTGGGGAGTTTACGGT -> AGATTGGGGAGTTTACGGTC
GAGCAAACATGTGTTAGCCG -> AGCAAACATGTGTTAGCCGT
GAGCAAACGTTGGGAGATTG -> AGCAAACGTTGGGAGATTGG
GAGCAATCTATTTGTCTACG -> AGCAATCTATTTGTCTACGC
GAGCCGTAGTTCAACGCTAA -> AGCCGTAGTTCAACGCTAAG
GAGCTCGGCTCTGTCCACGT -> AGCTCGGCTCTGTCCACGTC
GAGCTGTCAAGACTTGCGTC -> AGCTGTCAAGACTTGCGTCA
GAGGTCCGTCATAAAAGACA -> AGGTCCGTCATAAAAGACAT
GAGTCACGCGCGTGGTCTAG -> AGTCACGCGCGTGGTCTAGT
GAGTCCACAAGTTAGGCGAG -> AGTCCACAAGTTAGGCGAGC
GAGTCCCAGGCAGGGACTCA -> AGTCCCAGGCAGGGACTCAG
GAGTGCGGCACGGGCGTCCC -> AGTGCGGCACGGGCGTCCCA
GAGTTGGCAAAAGGGTCAGG -> AGTTGGCAAAAGGGTCAGGG
GAGTTTACGGTCTCACCTCA -> AGTTTACGGTCTCACCTCAT
GAGTTTCAGAGTGCGGCACG -> AGTTTCAGAGTGCGGCACGG
GATAAGAGCAAACGTTGGGA -> ATAAGAGCAAACGTTGGGAG
GATAAGCTACTTAAATTCTG -> ATAAGCTACTTAAATTCTGT
GATACAAATGCCTTAAGCGT -> ATACAAATGCCTTAAGCGTC
GATAGTAAATTACCTGAAGG -> ATAGTAAATTACCTGAAGGA
GATATGTAGCCCAACAACCG -> ATATGTAGCCCAACAACCGC
GATCAAGTCATATACGCCAC -> ATCAAGTCATATACGCCACG
GATCATCCGTACAGGCATAC -> ATCATCCGTACAGGCATACT
GATTACCTTACTCTTACGCT -> ATTACCTTACTCTTACGCTC
GATTATCAGTCCTATACTCA -> ATTATCAGTCCTATACTCAC
GATTGGGGAGTTTACGGTCT -> ATTGGGGAGTTTACGGTCTC
GATTGGGGTGTGCTGATATG -> ATTGGGGTGTGCTGATATGT
GATTGGTCTGATCAAGTCAT -> ATTGGTCTGATCAAGTCATA
GCAAAACACGGTAGAGATAA -> CAAAACACGGTAGAGATAAG
GCAAAAGGGTCAGGGCAAAG -> CAAAAGGGTCAGGGCAAAGG
GCAAACATGTGTTAGCCGTT -> CAAACATGTGTTAGCCGTTG
GCAAACGTTGGGAGATTGGG -> CAAACGTTGGGAGATTGGGG
GCAAAGGAGTCACGCGCGTG -> CAAAGGAGTCACGCGCGTGG
GCAATCTATTTGTCTACGCG -> CAATCTATTTGTCTACGCGT
GCACGGGCGTCCCAACCTTG -> CACGGGCGTCCCAACCTTGA
GCAGAATGATTATCAGTCCT -> CAGAATGATTATCAGTCCTA
GCAGGCAGTATGCCCTCAAT -> CAGGCAGTATGCCCTCAATC
GCAGGGACTCAGATAAGAGC -> CAGGGACTCAGATAAGAGCA
GCAGGTTTTCGGAGCTCGGC -> CAGGTTTTCGGAGCTCGGCT
GCAGTATGCCCTCAATCCCG -> CAGTATGCCCTCAATCCCGA
GCAGTGGGCCTCTAAGTCGG -> CAGTGGGCCTCTAAGTCGGG
GCATAAGTAAATGTATGCCG -> CATAAGTAAATGTATGCCGT
GCATACTGCAGGTTTTCGGA -> CATACTGCAGGTTTTCGGAG
GCATCGCGTCACTGTCAGGA -> CATCGCGTCACTGTCAGGAG
GCATGGGCGACTGCTGACAA -> CATGGGCGACTGCTGACAAG
GCCACGTCCGGGTTGATTGG -> CCACGTCCGGGTTGATTGGG
GCCATCTCGGATAGTAAATT -> CCATCTCGGATAGTAAATTA
GCCCAACAACCGCCATCTCG -> CCCAACAACCGCCATCTCGG
GCCCTAAACGTGGACAGTAG -> CCCTAAACGTGGACAGTAGC
GCCCTCAATCCCGAAGCATC -> CCCTCAATCCCGAAGCATCG
GCCGTAGTTCAACGCTAAGC -> CCGTAGTTCAACGCTAAGCG
GCCGTCTTCTAGGCATGGGC -> CCGTCTTCTAGGCATGGGCG
GCCGTTCTCGCAAAACACGG -> CCGTTCTCGCAAAACACGGT
GCCGTTGCATAAGTAAATGT -> CCGTTGCATAAGTAAATGTA
GCCTCTAAGTCGGGGTAACC -> CCTCTAAGTCGGGGTAACCA
GCCTTAAGCGTCATGTTCAG -> CCTTAAGCGTCATGTTCAGT
GCGACTGCTGACAAGGGGCT -> CGACTGCTGACAAGGGGCTC
GCGAGACATCGTTCTGTGTA -> CGAGACATCGTTCTGTGTAC
GCGAGCAATCTATTTGTCTA -> CGAGCAATCTATTTGTCTAC
GCGATTGGTCTGATCAAGTC -> CGATTGGTCTGATCAAGTCA
GCGCGTGGTCTAGTACGGGA -> CGCGTGGTCTAGTACGGGAT
GCGGCACGGGCGTCCCAACC -> CGGCACGGGCGTCCCAACCT
GCGGTTAGCTCTTTCCCAGC -> CGGTTAGCTCTTTCCCAGCC
GCGTCAATCCGCGATTGGTC -> CGTCAATCCGCGATTGGTCT
GCGTCACTGTCAGGAGCAAA -> CGTCACTGTCAGGAGCAAAC
GCGTCATGAAAGGTCCCGAG -> CGTCATGAAAGGTCCCGAGA
GCGTCATGTTCAGTTTTAAG -> CGTCATGTTCAGTTTTAAGG
GCGTCCCAACCTTGACGCAG -> CGTCCCAACCTTGACGCAGA
GCGTCTGTAACAAGATCATC -> CGTCTGTAACAAGATCATCC
GCGTGGTCTAGTACGGGATT -> CGTGGTCTAGTACGGGATTA
GCGTTTATGTATTTCTCAGA -> CGTTTATGTATTTCTCAGAC
GCTAAGCGAGACATCGTTCT -> CTAAGCGAGACATCGTTCTG
GCTACTTAAATTCTGTGGCT -> CTACTTAAATTCTGTGGCTG
GCTCAAGCTCCATATAGACA -> CTCAAGCTCCATATAGACAT
GCTCCATATAGACATAGAAT -> CTCCATATAGACATAGAATG
GCTCGCTCAAGCTCCATATA -> CTCGCTCAAGCTCCATATAG
GCTCGGCTCTGTCCACGTCG -> CTCGGCTCTGTCCACGTCGT
GCTCTCTACACATGAACGGT -> CTCTCTACACATGAACGGTC
GCTCTGTCCACGTCGTCATG -> CTCTGTCCACGTCGTCATGA
GCTCTTTCCCAGCCGTTCTC -> CTCTTTCCCAGCCGTTCTCG
GCTGACAAGGGGCTCTCTAC -> CTGACAAGGGGCTCTCTACA
GCTGATATGTAGCCCAACAA -> CTGATATGTAGCCCAACAAC
GCTGTCAAGACTTGCGTCAT -> CTGTCAAGACTTGCGTCATG
GCTGTGCAGGCAGTATGCCC -> CTGTGCAGGCAGTATGCCCT
GCTTAGGACAAATGTGAGTT -> CTTAGGACAAATGTGAGTTG
GGAACACGCTTAGGACAAAT -> GAACACGCTTAGGACAAATG
GGAACTGAGTCCACAAGTTA -> GAACTGAGTCCACAAGTTAG
GGACAAATGTGAGTTGGCAA -> GACAAATGTGAGTTGGCAAA
GGACAGTAGCGTTTATGTAT -> GACAGTAGCGTTTATGTATT
GGACTCAGATAAGAGCAAAC -> GACTCAGATAAGAGCAAACG
GGAGATTGGGGAGTTTACGG -> GAGATTGGGGAGTTTACGGT
GGAGCAAACATGTGTTAGCC -> GAGCAAACATGTGTTAGCCG
GGAGCTCGGCTCTGTCCACG -> GAGCTCGGCTCTGTCCACGT
GGAGCTGTCAAGACTTGCGT -> GAGCTGTCAAGACTTGCGTC
GGAGTCACGCGCGTGGTCTA -> GAGTCACGCGCGTGGTCTAG
GGAGTTTACGGTCTCACCTC -> GAGTTTACGGTCTCACCTCA
GGAGTTTCAGAGTGCGGCAC -> GAGTTTCAGAGTGCGGCACG
GGATAGTAAATTACCTGAAG -> GATAGTAAATTACCTGAAGG
GGATTACCTTACTCTTACGC -> GATTACCTTACTCTTACGCT
GGCAAAAGGGTCAGGGCAAA -> GCAAAAGGGTCAGGGCAAAG
GGCAAAGGAGTCACGCGCGT -> GCAAAGGAGTCACGCGCGTG
GGCACGGGCGTCCCAACCTT -> GCACGGGCGTCCCAACCTTG
GGCAGGGACTCAGATAAGAG -> GCAGGGACTCAGATAAGAGC
GGCAGTATGCCCTCAATCCC -> GCAGTATGCCCTCAATCCCG
GGCAGTGGGCCTCTAAGTCG -> GCAGTGGGCCTCTAAGTCGG
GGCATACTGCAGGTTTTCGG -> GCATACTGCAGGTTTTCGGA
GGCATGGGCGACTGCTGACA -> GCATGGGCGACTGCTGACAA
GGCCTCTAAGTCGGGGTAAC -> GCCTCTAAGTCGGGGTAACC
GGCGACTGCTGACAAGGGGC -> GCGACTGCTGACAAGGGGCT
GGCGAGCAATCTATTTGTCT -> GCGAGCAATCTATTTGTCTA
GGCGTCAATCCGCGATTGGT -> GCGTCAATCCGCGATTGGTC
GGCGTCCCAACCTTGACGCA -> GCGTCCCAACCTTGACGCAG
GGCTCTCTACACATGAACGG -> GCTCTCTACACATGAACGGT
GGCTCTGTCCACGTCGTCAT -> GCTCTGTCCACGTCGTCATG
GGCTGTGCAGGCAGTATGCC -> GCTGTGCAGGCAGTATGCCC
GGGAACTGAGTCCACAAGTT -> GGAACTGAGTCCACAAGTTA
GGGACTCAGATAAGAGCAAA -> GGACTCAGATAAGAGCAAAC
GGGAGATTGGGGAGTTTACG -> GGAGATTGGGGAGTTTACGG
GGGAGTTTACGGTCTCACCT -> GGAGTTTACGGTCTCACCTC
GGGAGTTTCAGAGTGCGGCA -> GGAGTTTCAGAGTGCGGCAC
GGGATTACCTTACTCTTACG -> GGATTACCTTACTCTTACGC
GGGCAAAGGAGTCACGCGCG -> GGCAAAGGAGTCACGCGCGT
GGGCCTCTAAGTCGGGGTAA -> GGCCTCTAAGTCGGGGTAAC
GGGCGACTGCTGACAAGGGG -> GGCGACTGCTGACAAGGGGC
GGGCGTCCCAACCTTGACGC -> GGCGTCCCAACCTTGACGCA
GGGCTCTCTACACATGAACG -> GGCTCTCTACACATGAACGG
GGGGAGTTTACGGTCTCACC -> GGGAGTTTACGGTCTCACCT
GGGGCTCTCTACACATGAAC -> GGGCTCTCTACACATGAACG
GGGGTAACCACGCCCTAAAC -> GGGTAACCACGCCCTAAACG
GGGGTCGGGAACTGAGTCCA -> GGGTCGGGAACTGAGTCCAC
GGGGTGTGCTGATATGTAGC -> GGGTGTGCTGATATGTAGCC
GGGTAACCACGCCCTAAACG -> GGTAACCACGCCCTAAACGT
GGGTCAGGGCAAAGGAGTCA -> GGTCAGGGCAAAGGAGTCAC
GGGTCGGGAACTGAGTCCAC -> GGTCGGGAACTGAGTCCACA
GGGTGTGCTGATATGTAGCC -> GGTGTGCTGATATGTAGCCC
GGGTTGATTGGGGTGTGCTG -> GGTTGATTGGGGTGTGCTGA
GGTAACCACGCCCTAAACGT -> GTAACCACGCCCTAAACGTG
GGTAGAGATAAGCTACTTAA -> GTAGAGATAAGCTACTTAAA
GGTCAGGGCAAAGGAGTCAC -> GTCAGGGCAAAGGAGTCACG
GGTCCCGAGACTGAACGGCG -> GTCCCGAGACTGAACGGCGT
GGTCCGTCATAAAAGACATG -> GTCCGTCATAAAAGACATGG
GGTCCTTAGGTCGGCAGTGG -> GTCCTTAGGTCGGCAGTGGG
GGTCGAGTCCCAGGCAGGGA -> GTCGAGTCCCAGGCAGGGAC
GGTCGGCAGTGGGCCTCTAA -> GTCGGCAGTGGGCCTCTAAG
GGTCGGGAACTGAGTCCACA -> GTCGGGAACTGAGTCCACAA
GGTCTAGTACGGGATTACCT -> GTCTAGTACGGGATTACCTT
GGTCTCACCTCATGACCAAT -> GTCTCACCTCATGACCAATT
GGTCTGATCAAGTCATATAC -> GTCTGATCAAGTCATATACG
GGTGTGCTGATATGTAGCCC -> GTGTGCTGATATGTAGCCCA
GGTTAGCTCTTTCCCAGCCG -> GTTAGCTCTTTCCCAGCCGT
GGTTGATTGGGGTGTGCTGA -> GTTGATTGGGGTGTGCTGAT
GGTTTTCGGAGCTCGGCTCT -> GTTTTCGGAGCTCGGCTCTG
GTAAATGTATGCCGTCTTCT -> TAAATGTATGCCGTCTTCTA
GTAAATTACCTGAAGGAACA -> TAAATTACCTGAAGGAACAC
GTAACAAGATCATCCGTACA -> TAACAAGATCATCCGTACAG
GTAACCACGCCCTAAACGTG -> TAACCACGCCCTAAACGTGG
GTACAGGCATACTGCAGGTT -> TACAGGCATACTGCAGGTTT
GTACGGGATTACCTTACTCT -> TACGGGATTACCTTACTCTT
GTACTAAGATACAAATGCCT -> TACTAAGATACAAATGCCTT
GTACTAAGTACTAAGATACA -> TACTAAGTACTAAGATACAA
GTACTACAAGAATTTTGTCC -> TACTACAAGAATTTTGTCCA
GTAGAGATAAGCTACTTAAA -> TAGAGATAAGCTACTTAAAT
GTAGCCCAACAACCGCCATC -> TAGCCCAACAACCGCCATCT
GTAGCGTTTATGTATTTCTC -> TAGCGTTTATGTATTTCTCA
GTAGTTCAACGCTAAGCGAG -> TAGTTCAACGCTAAGCGAGA
GTATGCCCTCAATCCCGAAG -> TATGCCCTCAATCCCGAAGC
GTATGCCGTCTTCTAGGCAT -> TATGCCGTCTTCTAGGCATG
GTATTTCTCAGACGAAAGAC -> TATTTCTCAGACGAAAGACT
GTCAAGACTTGCGTCATGAA -> TCAAGACTTGCGTCATGAAA
GTCAATCCGCGATTGGTCTG -> TCAATCCGCGATTGGTCTGA
GTCACGCGCGTGGTCTAGTA -> TCACGCGCGTGGTCTAGTAC
GTCACTGTCAGGAGCAAACA -> TCACTGTCAGGAGCAAACAT
GTCAGGAGCAAACATGTGTT -> TCAGGAGCAAACATGTGTTA
GTCAGGGCAAAGGAGTCACG -> TCAGGGCAAAGGAGTCACGC
GTCATAAAAGACATGGTCGA -> TCATAAAAGACATGGTCGAG
GTCATATACGCCACGTCCGG -> TCATATACGCCACGTCCGGG
GTCATGAAAGGTCCCGAGAC -> TCATGAAAGGTCCCGAGACT
GTCATGAGCCGTAGTTCAAC -> TCATGAGCCGTAGTTCAACG
GTCATGTTCAGTTTTAAGGA -> TCATGTTCAGTTTTAAGGAG
GTCCACAAGTTAGGCGAGCA -> TCCACAAGTTAGGCGAGCAA
GTCCACCATGGGGTCGGGAA -> TCCACCATGGGGTCGGGAAC
GTCCACGTCGTCATGAGCCG -> TCCACGTCGTCATGAGCCGT
GTCCCAACCTTGACGCAGAA -> TCCCAACCTTGACGCAGAAT
GTCCCAGGCAGGGACTCAGA -> TCCCAGGCAGGGACTCAGAT
GTCCCGAGACTGAACGGCGT -> TCCCGAGACTGAACGGCGTC
GTCCGGGTTGATTGGGGTGT -> TCCGGGTTGATTGGGGTGTG
GTCCGTCATAAAAGACATGG -> TCCGTCATAAAAGACATGGT
GTCCTATACTCACACGAGGT -> TCCTATACTCACACGAGGTC
GTCCTTAGGTCGGCAGTGGG -> TCCTTAGGTCGGCAGTGGGC
GTCGAGTCCCAGGCAGGGAC -> TCGAGTCCCAGGCAGGGACT
GTCGGCAGTGGGCCTCTAAG -> TCGGCAGTGGGCCTCTAAGT
GTCGGGAACTGAGTCCACAA -> TCGGGAACTGAGTCCACAAG
GTCGGGGTAACCACGCCCTA -> TCGGGGTAACCACGCCCTAA
GTCGTCATGAGCCGTAGTTC -> TCGTCATGAGCCGTAGTTCA
GTCTACGCGTCTGTAACAAG -> TCTACGCGTCTGTAACAAGA
GTCTAGTACGGGATTACCTT -> TCTAGTACGGGATTACCTTA
GTCTCACCTCATGACCAATT -> TCTCACCTCATGACCAATTA
GTCTGATCAAGTCATATACG -> TCTGATCAAGTCATATACGC
GTCTGTAACAAGATCATCCG -> TCTGTAACAAGATCATCCGT
GTCTTCTAGGCATGGGCGAC -> TCTTCTAGGCATGGGCGACT
GTGAGTTGGCAAAAGGGTCA -> TGAGTTGGCAAAAGGGTCAG
GTGCAGGCAGTATGCCCTCA -> TGCAGGCAGTATGCCCTCAA
GTGCGGCACGGGCGTCCCAA -> TGCGGCACGGGCGTCCCAAC
GTGCTGATATGTAGCCCAAC -> TGCTGATATGTAGCCCAACA
GTGGACAGTAGCGTTTATGT -> TGGACAGTAGCGTTTATGTA
GTGGCTGTGCAGGCAGTATG -> TGGCTGTGCAGGCAGTATGC
GTGGGCCTCTAAGTCGGGGT -> TGGGCCTCTAAGTCGGGGTA
GTGGTCTAGTACGGGATTAC -> TGGTCTAGTACGGGATTACC
GTGTACTAAGTACTAAGATA -> TGTACTAAGTACTAAGATAC
GTGTGCTGATATGTAGCCCA -> TGTGCTGATATGTAGCCCAA
GTGTTAGCCGTTGCATAAGT -> TGTTAGCCGTTGCATAAGTA
GTTACCGAACCTGGGAGTTT -> TTACCGAACCTGGGAGTTTC
GTTAGCCGTTGCATAAGTAA -> TTAGCCGTTGCATAAGTAAA
GTTAGCTCTTTCCCAGCCGT -> TTAGCTCTTTCCCAGCCGTT
GTTAGGCGAGCAATCTATTT -> TTAGGCGAGCAATCTATTTG
GTTCAACGCTAAGCGAGACA -> TTCAACGCTAAGCGAGACAT
GTTCAGTTTTAAGGAGCTGT -> TTCAGTTTTAAGGAGCTGTC
GTTCTCGCAAAACACGGTAG -> TTCTCGCAAAACACGGTAGA
GTTCTGTGTACTAAGTACTA -> TTCTGTGTACTAAGTACTAA
GTTGATTGGGGTGTGCTGAT -> TTGATTGGGGTGTGCTGATA
GTTGCATAAGTAAATGTATG -> TTGCATAAGTAAATGTATGC
GTTGGCAAAAGGGTCAGGGC -> TTGGCAAAAGGGTCAGGGCA
GTTGGGAGATTGGGGAGTTT -> TTGGGAGATTGGGGAGTTTA
GTTTACGGTCTCACCTCATG -> TTTACGGTCTCACCTCATGA
GTTTATGTATTTCTCAGACG -> TTTATGTATTTCTCAGACGA
GTTTCAGAGTGCGGCACGGG -> TTTCAGAGTGCGGCACGGGC
GTTTTAAGGAGCTGTCAAGA -> TTTTAAGGAGCTGTCAAGAC
GTTTTCGGAGCTCGGCTCTG -> TTTTCGGAGCTCGGCTCTGT
GTTTTGTTACCGAACCTGGG -> TTTTGTTACCGAACCTGGGA
TAAAAGACATGGTCGAGTCC -> AAAAGACATGGTCGAGTCCC
TAAACAGTTTTGTTACCGAA -> AAACAGTTTTGTTACCGAAC
TAAACGTGGACAGTAGCGTT -> AAACGTGGACAGTAGCGTTT
TAAATGTATGCCGTCTTCTA -> AAATGTATGCCGTCTTCTAG
TAAATTACCTGAAGGAACAC -> AAATTACCTGAAGGAACACG
TAAATTCTGTGGCTGTGCAG -> AAATTCTGTGGCTGTGCAGG
TAACAAGATCATCCGTACAG -> AACAAGATCATCCGTACAGG
TAACCACGCCCTAAACGTGG -> AACCACGCCCTAAACGTGGA
TAAGAGCAAACGTTGGGAGA -> AAGAGCAAACGTTGGGAGAT
TAAGATACAAATGCCTTAAG -> AAGATACAAATGCCTTAAGC
TAAGCGAGACATCGTTCTGT -> AAGCGAGACATCGTTCTGTG
TAAGCGTCATGTTCAGTTTT -> AAGCGTCATGTTCAGTTTTA
TAAGCTACTTAAATTCTGTG -> AAGCTACTTAAATTCTGTGG
TAAGGAGCTGTCAAGACTTG -> AAGGAGCTGTCAAGACTTGC
TAAGTAAATGTATGCCGTCT -> AAGTAAATGTATGCCGTCTT
TAAGTACTAAGATACAAATG -> AAGTACTAAGATACAAATGC
TAAGTCGGGGTAACCACGCC -> AAGTCGGGGTAACCACGCCC
TACAAATGCCTTAAGCGTCA -> ACAAATGCCTTAAGCGTCAT
TACAAGAATTTTGTCCACCA -> ACAAGAATTTTGTCCACCAT
TACACATGAACGGTCCTTAG -> ACACATGAACGGTCCTTAGG
TACAGGCATACTGCAGGTTT -> ACAGGCATACTGCAGGTTTT
TACCGAACCTGGGAGTTTCA -> ACCGAACCTGGGAGTTTCAG
TACCTGAAGGAACACGCTTA -> ACCTGAAGGAACACGCTTAG
TACCTTACTCTTACGCTCGC -> ACCTTACTCTTACGCTCGCT
TACGAAGTACTACAAGAATT -> ACGAAGTACTACAAGAATTT
TACGCCACGTCCGGGTTGAT -> ACGCCACGTCCGGGTTGATT
TACGCGTCTGTAACAAGATC -> ACGCGTCTGTAACAAGATCA
TACGCTCGCTCAAGCTCCAT -> ACGCTCGCTCAAGCTCCATA
TACGGGATTACCTTACTCTT -> ACGGGATTACCTTACTCTTA
TACGGTCTCACCTCATGACC -> ACGGTCTCACCTCATGACCA
TACTAAGATACAAATGCCTT -> ACTAAGATACAAATGCCTTA
TACTAAGTACTAAGATACAA -> ACTAAGTACTAAGATACAAA
TACTACAAGAATTTTGTCCA -> ACTACAAGAATTTTGTCCAC
TACTCACACGAGGTCCGTCA -> ACTCACACGAGGTCCGTCAT
TACTCTTACGCTCGCTCAAG -> ACTCTTACGCTCGCTCAAGC
TACTGCAGGTTTTCGGAGCT -> ACTGCAGGTTTTCGGAGCTC
TACTTAAATTCTGTGGCTGT -> ACTTAAATTCTGTGGCTGTG
TAGAATGCGGTTAGCTCTTT -> AGAATGCGGTTAGCTCTTTC
TAGACATAGAATGCGGTTAG -> AGACATAGAATGCGGTTAGC
TAGAGATAAGCTACTTAAAT -> AGAGATAAGCTACTTAAATT
TAGCCCAACAACCGCCATCT -> AGCCCAACAACCGCCATCTC
TAGCCGTTGCATAAGTAAAT -> AGCCGTTGCATAAGTAAATG
TAGCGTTTATGTATTTCTCA -> AGCGTTTATGTATTTCTCAG
TAGCTCTTTCCCAGCCGTTC -> AGCTCTTTCCCAGCCGTTCT
TAGGACAAATGTGAGTTGGC -> AGGACAAATGTGAGTTGGCA
TAGGCATGGGCGACTGCTGA -> AGGCATGGGCGACTGCTGAC
TAGGCGAGCAATCTATTTGT -> AGGCGAGCAATCTATTTGTC
TAGGTCGGCAGTGGGCCTCT -> AGGTCGGCAGTGGGCCTCTA
TAGTAAATTACCTGAAGGAA -> AGTAAATTACCTGAAGGAAC
TAGTACGGGATTACCTTACT -> AGTACGGGATTACCTTACTC
TAGTTCAACGCTAAGCGAGA -> AGTTCAACGCTAAGCGAGAC
TATACGCCACGTCCGGGTTG -> ATACGCCACGTCCGGGTTGA
TATACTCACACGAGGTCCGT -> ATACTCACACGAGGTCCGTC
TATAGACATAGAATGCGGTT -> ATAGACATAGAATGCGGTTA
TATCAGTCCTATACTCACAC -> ATCAGTCCTATACTCACACG
TATGCCCTCAATCCCGAAGC -> ATGCCCTCAATCCCGAAGCA
TATGCCGTCTTCTAGGCATG -> ATGCCGTCTTCTAGGCATGG
TATGTAGCCCAACAACCGCC -> ATGTAGCCCAACAACCGCCA
TATGTATTTCTCAGACGAAA -> ATGTATTTCTCAGACGAAAG
TATTTCTCAGACGAAAGACT -> ATTTCTCAGACGAAAGACTC
TATTTGTCTACGCGTCTGTA -> ATTTGTCTACGCGTCTGTAA
TCAACGCTAAGCGAGACATC -> CAACGCTAAGCGAGACATCG
TCAAGACTTGCGTCATGAAA -> CAAGACTTGCGTCATGAAAG
TCAAGCTCCATATAGACATA -> CAAGCTCCATATAGACATAG
TCAAGTCATATACGCCACGT -> CAAGTCATATACGCCACGTC
TCAATCCCGAAGCATCGCGT -> CAATCCCGAAGCATCGCGTC
TCAATCCGCGATTGGTCTGA -> CAATCCGCGATTGGTCTGAT
TCACACGAGGTCCGTCATAA -> CACACGAGGTCCGTCATAAA
TCACCTCATGACCAATTACG -> CACCTCATGACCAATTACGA
TCACGCGCGTGGTCTAGTAC -> CACGCGCGTGGTCTAGTACG
TCACTGTCAGGAGCAAACAT -> CACTGTCAGGAGCAAACATG
TCAGAGTGCGGCACGGGCGT -> CAGAGTGCGGCACGGGCGTC
TCAGATAAGAGCAAACGTTG -> CAGATAAGAGCAAACGTTGG
TCAGGAGCAAACATGTGTTA -> CAGGAGCAAACATGTGTTAG
TCAGGGCAAAGGAGTCACGC -> CAGGGCAAAGGAGTCACGCG
TCAGTCCTATACTCACACGA -> CAGTCCTATACTCACACGAG
TCAGTTTTAAGGAGCTGTCA -> CAGTTTTAAGGAGCTGTCAA
TCATAAAAGACATGGTCGAG -> CATAAAAGACATGGTCGAGT
TCATATACGCCACGTCCGGG -> CATATACGCCACGTCCGGGT
TCATCCGTACAGGCATACTG -> CATCCGTACAGGCATACTGC
TCATGAAAGGTCCCGAGACT -> CATGAAAGGTCCCGAGACTG
TCATGACCAATTACGAAGTA -> CATGACCAATTACGAAGTAC
TCATGAGCCGTAGTTCAACG -> CATGAGCCGTAGTTCAACGC
TCATGTTCAGTTTTAAGGAG -> CATGTTCAGTTTTAAGGAGC
TCCACAAGTTAGGCGAGCAA -> CCACAAGTTAGGCGAGCAAT
TCCACCATGGGGTCGGGAAC -> CCACCATGGGGTCGGGAACT
TCCACGTCGTCATGAGCCGT -> CCACGTCGTCATGAGCCGTA
TCCATATAGACATAGAATGC -> CCATATAGACATAGAATGCG
TCCCAACCTTGACGCAGAAT -> CCCAACCTTGACGCAGAATG
TCCCAGCCGTTCTCGCAAAA -> CCCAGCCGTTCTCGCAAAAC
TCCCAGGCAGGGACTCAGAT -> CCCAGGCAGGGACTCAGATA
TCCCGAAGCATCGCGTCACT -> CCCGAAGCATCGCGTCACTG
TCCCGAGACTGAACGGCGTC -> CCCGAGACTGAACGGCGTCA
TCCGCGATTGGTCTGATCAA -> CCGCGATTGGTCTGATCAAG
TCCGGGTTGATTGGGGTGTG -> CCGGGTTGATTGGGGTGTGC
TCCGTACAGGCATACTGCAG -> CCGTACAGGCATACTGCAGG
TCCGTCATAAAAGACATGGT -> CCGTCATAAAAGACATGGTC
TCCTATACTCACACGAGGTC -> CCTATACTCACACGAGGTCC
TCCTTAGGTCGGCAGTGGGC -> CCTTAGGTCGGCAGTGGGCC
TCGAGTCCCAGGCAGGGACT -> CGAGTCCCAGGCAGGGACTC
TCGCAAAACACGGTAGAGAT -> CGCAAAACACGGTAGAGATA
TCGCGTCACTGTCAGGAGCA -> CGCGTCACTGTCAGGAGCAA
TCGCTCAAGCTCCATATAGA -> CGCTCAAGCTCCATATAGAC
TCGGAGCTCGGCTCTGTCCA -> CGGAGCTCGGCTCTGTCCAC
TCGGATAGTAAATTACCTGA -> CGGATAGTAAATTACCTGAA
TCGGCAGTGGGCCTCTAAGT -> CGGCAGTGGGCCTCTAAGTC
TCGGCTCTGTCCACGTCGTC -> CGGCTCTGTCCACGTCGTCA
TCGGGAACTGAGTCCACAAG -> CGGGAACTGAGTCCACAAGT
TCGGGGTAACCACGCCCTAA -> CGGGGTAACCACGCCCTAAA
TCGTCATGAGCCGTAGTTCA -> CGTCATGAGCCGTAGTTCAA
TCGTTCTGTGTACTAAGTAC -> CGTTCTGTGTACTAAGTACT
TCTAAGTCGGGGTAACCACG -> CTAAGTCGGGGTAACCACGC
TCTACACATGAACGGTCCTT -> CTACACATGAACGGTCCTTA
TCTACGCGTCTGTAACAAGA -> CTACGCGTCTGTAACAAGAT
TCTAGGCATGGGCGACTGCT -> CTAGGCATGGGCGACTGCTG
TCTAGTACGGGATTACCTTA -> CTAGTACGGGATTACCTTAC
TCTATTTGTCTACGCGTCTG -> CTATTTGTCTACGCGTCTGT
TCTCACCTCATGACCAATTA -> CTCACCTCATGACCAATTAC
TCTCGCAAAACACGGTAGAG -> CTCGCAAAACACGGTAGAGA
TCTCGGATAGTAAATTACCT -> CTCGGATAGTAAATTACCTG
TCTCTACACATGAACGGTCC -> CTCTACACATGAACGGTCCT
TCTGATCAAGTCATATACGC -> CTGATCAAGTCATATACGCC
TCTGTAACAAGATCATCCGT -> CTGTAACAAGATCATCCGTA
TCTGTCCACGTCGTCATGAG -> CTGTCCACGTCGTCATGAGC
TCTGTGGCTGTGCAGGCAGT -> CTGTGGCTGTGCAGGCAGTA
TCTGTGTACTAAGTACTAAG -> CTGTGTACTAAGTACTAAGA
TCTTACGCTCGCTCAAGCTC -> CTTACGCTCGCTCAAGCTCC
TCTTCTAGGCATGGGCGACT -> CTTCTAGGCATGGGCGACTG
TCTTTCCCAGCCGTTCTCGC -> CTTTCCCAGCCGTTCTCGCA
TGAAAGGTCCCGAGACTGAA -> GAAAGGTCCCGAGACTGAAC
TGAACGGCGTCAATCCGCGA -> GAACGGCGTCAATCCGCGAT
TGAACGGTCCTTAGGTCGGC -> GAACGGTCCTTAGGTCGGCA
TGAAGGAACACGCTTAGGAC -> GAAGGAACACGCTTAGGACA
TGACAAGGGGCTCTCTACAC -> GACAAGGGGCTCTCTACACA
TGACCAATTACGAAGTACTA -> GACCAATTACGAAGTACTAC
TGACGCAGAATGATTATCAG -> GACGCAGAATGATTATCAGT
TGAGCCGTAGTTCAACGCTA -> GAGCCGTAGTTCAACGCTAA
TGAGTCCACAAGTTAGGCGA -> GAGTCCACAAGTTAGGCGAG
TGAGTTGGCAAAAGGGTCAG -> GAGTTGGCAAAAGGGTCAGG
TGATATGTAGCCCAACAACC -> GATATGTAGCCCAACAACCG
TGATCAAGTCATATACGCCA -> GATCAAGTCATATACGCCAC
TGATTATCAGTCCTATACTC -> GATTATCAGTCCTATACTCA
TGATTGGGGTGTGCTGATAT -> GATTGGGGTGTGCTGATATG
TGCAGGCAGTATGCCCTCAA -> GCAGGCAGTATGCCCTCAAT
TGCAGGTTTTCGGAGCTCGG -> GCAGGTTTTCGGAGCTCGGC
TGCATAAGTAAATGTATGCC -> GCATAAGTAAATGTATGCCG
TGCCCTCAATCCCGAAGCAT -> GCCCTCAATCCCGAAGCATC
TGCCGTCTTCTAGGCATGGG -> GCCGTCTTCTAGGCATGGGC
TGCCTTAAGCGTCATGTTCA -> GCCTTAAGCGTCATGTTCAG
TGCGGCACGGGCGTCCCAAC -> GCGGCACGGGCGTCCCAACC
TGCGGTTAGCTCTTTCCCAG -> GCGGTTAGCTCTTTCCCAGC
TGCGTCATGAAAGGTCCCGA -> GCGTCATGAAAGGTCCCGAG
TGCTGACAAGGGGCTCTCTA -> GCTGACAAGGGGCTCTCTAC
TGCTGATATGTAGCCCAACA -> GCTGATATGTAGCCCAACAA
TGGACAGTAGCGTTTATGTA -> GGACAGTAGCGTTTATGTAT
TGGCAAAAGGGTCAGGGCAA -> GGCAAAAGGGTCAGGGCAAA
TGGCTGTGCAGGCAGTATGC -> GGCTGTGCAGGCAGTATGCC
TGGGAGATTGGGGAGTTTAC -> GGGAGATTGGGGAGTTTACG
TGGGAGTTTCAGAGTGCGGC -> GGGAGTTTCAGAGTGCGGCA
TGGGCCTCTAAGTCGGGGTA -> GGGCCTCTAAGTCGGGGTAA
TGGGCGACTGCTGACAAGGG -> GGGCGACTGCTGACAAGGGG
TGGGGAGTTTACGGTCTCAC -> GGGGAGTTTACGGTCTCACC
TGGGGTCGGGAACTGAGTCC -> GGGGTCGGGAACTGAGTCCA
TGGGGTGTGCTGATATGTAG -> GGGGTGTGCTGATATGTAGC
TGGTCGAGTCCCAGGCAGGG -> GGTCGAGTCCCAGGCAGGGA
TGGTCTAGTACGGGATTACC -> GGTCTAGTACGGGATTACCT
TGGTCTGATCAAGTCATATA -> GGTCTGATCAAGTCATATAC
TGTAACAAGATCATCCGTAC -> GTAACAAGATCATCCGTACA
TGTACTAAGTACTAAGATAC -> GTACTAAGTACTAAGATACA
TGTAGCCCAACAACCGCCAT -> GTAGCCCAACAACCGCCATC
TGTATGCCGTCTTCTAGGCA -> GTATGCCGTCTTCTAGGCAT
TGTATTTCTCAGACGAAAGA -> GTATTTCTCAGACGAAAGAC
TGTCAAGACTTGCGTCATGA -> GTCAAGACTTGCGTCATGAA
TGTCAGGAGCAAACATGTGT -> GTCAGGAGCAAACATGTGTT
TGTCCACCATGGGGTCGGGA -> GTCCACCATGGGGTCGGGAA
TGTCCACGTCGTCATGAGCC -> GTCCACGTCGTCATGAGCCG
TGTCTACGCGTCTGTAACAA -> GTCTACGCGTCTGTAACAAG
TGTGAGTTGGCAAAAGGGTC -> GTGAGTTGGCAAAAGGGTCA
TGTGCAGGCAGTATGCCCTC -> GTGCAGGCAGTATGCCCTCA
TGTGCTGATATGTAGCCCAA -> GTGCTGATATGTAGCCCAAC
TGTGGCTGTGCAGGCAGTAT -> GTGGCTGTGCAGGCAGTATG
TGTGTACTAAGTACTAAGAT -> GTGTACTAAGTACTAAGATA
TGTGTTAGCCGTTGCATAAG -> GTGTTAGCCGTTGCATAAGT
TGTTACCGAACCTGGGAGTT -> GTTACCGAACCTGGGAGTTT
TGTTAGCCGTTGCATAAGTA -> GTTAGCCGTTGCATAAGTAA
TGTTCAGTTTTAAGGAGCTG -> GTTCAGTTTTAAGGAGCTGT
TTAAATTCTGTGGCTGTGCA -> TAAATTCTGTGGCTGTGCAG
TTAAGCGTCATGTTCAGTTT -> TAAGCGTCATGTTCAGTTTT
TTAAGGAGCTGTCAAGACTT -> TAAGGAGCTGTCAAGACTTG
TTACCGAACCTGGGAGTTTC -> TACCGAACCTGGGAGTTTCA
TTACCTGAAGGAACACGCTT -> TACCTGAAGGAACACGCTTA
TTACCTTACTCTTACGCTCG -> TACCTTACTCTTACGCTCGC
TTACGAAGTACTACAAGAAT -> TACGAAGTACTACAAGAATT
TTACGCTCGCTCAAGCTCCA -> TACGCTCGCTCAAGCTCCAT
TTACGGTCTCACCTCATGAC -> TACGGTCTCACCTCATGACC
TTACTCTTACGCTCGCTCAA -> TACTCTTACGCTCGCTCAAG
TTAGCCGTTGCATAAGTAAA -> TAGCCGTTGCATAAGTAAAT
TTAGCTCTTTCCCAGCCGTT -> TAGCTCTTTCCCAGCCGTTC
TTAGGACAAATGTGAGTTGG -> TAGGACAAATGTGAGTTGGC
TTAGGCGAGCAATCTATTTG -> TAGGCGAGCAATCTATTTGT
TTAGGTCGGCAGTGGGCCTC -> TAGGTCGGCAGTGGGCCTCT
TTATCAGTCCTATACTCACA -> TATCAGTCCTATACTCACAC
TTATGTATTTCTCAGACGAA -> TATGTATTTCTCAGACGAAA
TTCAACGCTAAGCGAGACAT -> TCAACGCTAAGCGAGACATC
TTCAGAGTGCGGCACGGGCG -> TCAGAGTGCGGCACGGGCGT
TTCAGTTTTAAGGAGCTGTC -> TCAGTTTTAAGGAGCTGTCA
TTCCCAGCCGTTCTCGCAAA -> TCCCAGCCGTTCTCGCAAAA
TTCGGAGCTCGGCTCTGTCC -> TCGGAGCTCGGCTCTGTCCA
TTCTAGGCATGGGCGACTGC -> TCTAGGCATGGGCGACTGCT
TTCTCAGACGAAAGACTCAA -> TCTCAGACGAAAGACTCAAC
TTCTCGCAAAACACGGTAGA -> TCTCGCAAAACACGGTAGAG
TTCTGTGGCTGTGCAGGCAG -> TCTGTGGCTGTGCAGGCAGT
TTCTGTGTACTAAGTACTAA -> TCTGTGTACTAAGTACTAAG
TTGACGCAGAATGATTATCA -> TGACGCAGAATGATTATCAG
TTGATTGGGGTGTGCTGATA -> TGATTGGGGTGTGCTGATAT
TTGCATAAGTAAATGTATGC -> TGCATAAGTAAATGTATGCC
TTGCGTCATGAAAGGTCCCG -> TGCGTCATGAAAGGTCCCGA
TTGGCAAAAGGGTCAGGGCA -> TGGCAAAAGGGTCAGGGCAA
TTGGGAGATTGGGGAGTTTA -> TGGGAGATTGGGGAGTTTAC
TTGGGGAGTTTACGGTCTCA -> TGGGGAGTTTACGGTCTCAC
TTGGGGTGTGCTGATATGTA -> TGGGGTGTGCTGATATGTAG
TTGGTCTGATCAAGTCATAT -> TGGTCTGATCAAGTCATATA
TTGTCCACCATGGGGTCGGG -> TGTCCACCATGGGGTCGGGA
TTGTCTACGCGTCTGTAACA -> TGTCTACGCGTCTGTAACAA
TTGTTACCGAACCTGGGAGT -> TGTTACCGAACCTGGGAGTT
TTTAAGGAGCTGTCAAGACT -> TTAAGGAGCTGTCAAGACTT
TTTACGGTCTCACCTCATGA -> TTACGGTCTCACCTCATGAC
TTTATGTATTTCTCAGACGA -> TTATGTATTTCTCAGACGAA
TTTCAGAGTGCGGCACGGGC -> TTCAGAGTGCGGCACGGGCG
TTTCCCAGCCGTTCTCGCAA -> TTCCCAGCCGTTCTCGCAAA
TTTCGGAGCTCGGCTCTGTC -> TTCGGAGCTCGGCTCTGTCC
TTTCTCAGACGAAAGACTCA -> TTCTCAGACGAAAGACTCAA
TTTGTCCACCATGGGGTCGG -> TTGTCCACCATGGGGTCGGG
TTTGTCTACGCGTCTGTAAC -> TTGTCTACGCGTCTGTAACA
TTTGTTACCGAACCTGGGAG -> TTGTTACCGAACCTGGGAGT
TTTTAAGGAGCTGTCAAGAC -> TTTAAGGAGCTGTCAAGACT
TTTTCGGAGCTCGGCTCTGT -> TTTCGGAGCTCGGCTCTGTC
TTTTGTCCACCATGGGGTCG -> TTTGTCCACCATGGGGTCGG
TTTTGTTACCGAACCTGGGA -> TTTGTTACCGAACCTGGGAG
