AAAAACGCGTT -> AAAACGCGTTT
AAAAAGAAGTG -> AAAAGAAGTGC
AAAAATGCGCA -> AAAATGCGCAA
AAAACATGTAA -> AAACATGTAAC
AAAACGCGTTT -> AAACGCGTTTG
AAAAGAAGTGC -> AAAGAAGTGCG
AAAATCCGACT -> AAATCCGACTT
AAAATCGATAC -> AAATCGATACG
AAAATGCGCAA -> AAATGCGCAAG
AAACAGCCCGA -> AACAGCCCGAA
AAACATGTAAC -> AACATGTAACT
AAACATTTAAA -> AACATTTAAAG
AAACGCGTTTG -> AACGCGTTTGT
AAACGCTGAAA -> AACGCTGAAAG
AAAGAAGTGCG -> AAGAAGTGCGT
AAAGAAGTGGC -> AAGAAGTGGCA
AAAGAGATGAC -> AAGAGATGACA
AAAGCACTGAA -> AAGCACTGAAC
AAAGCCCTTCT -> AAGCCCTTCTA
AAAGCTATCTA -> AAGCTATCTAA
AAAGGCCGTAA -> AAGGCCGTAAC
AAAGGCCTGTT -> AAGGCCTGTTA
AAAGGGCTTAA -> AAGGGCTTAAT
AAAGTAACCAA -> AAGTAACCAAG
AAAGTTCCAGT -> AAGTTCCAGTG
AAAGTTTTTAG -> AAGTTTTTAGG
AAATAACGACC -> AATAACGACCG
AAATACCCTCT -> AATACCCTCTC
AAATCCGACTT -> AATCCGACTTG
AAATCGATACG -> AATCGATACGC
AAATGCGCAAG -> AATGCGCAAGC
AAATTACAGCG -> AATTACAGCGT
AAATTACCTTC -> AATTACCTTCG
AAATTATCACT -> AATTATCACTT
AACACAACGCT -> ACACAACGCTA
AACAGCCCGAA -> ACAGCCCGAAA
AACATGTAACT -> ACATGTAACTC
AACATTTAAAG -> ACATTTAAAGT
AACCAAGTTAA -> ACCAAGTTAAT
AACCACAACAC -> ACCACAACACA
AACCAGACCTT -> ACCAGACCTTG
AACCAGACTTG -> ACCAGACTTGC
AACCCAATCTA -> ACCCAATCTAC
AACCCGAGCAC -> ACCCGAGCACA
AACCCGGCACG -> ACCCGGCACGA
AACCGAAGCAC -> ACCGAAGCACG
AACCGAGCTAA -> ACCGAGCTAAT
AACCGGCGTCC -> ACCGGCGTCCG
AACCGTTTAAT -> ACCGTTTAATT
AACGACATCTA -> ACGACATCTAG
AACGACCGATC -> ACGACCGATCG
AACGCAGCGAT -> ACGCAGCGATG
AACGCGTTTGT -> ACGCGTTTGTT
AACGCTACCCC -> ACGCTACCCCT
AACGCTGAAAG -> ACGCTGAAAGC
AACGGATCCCC -> ACGGATCCCCT
AACGGCTGTAC -> ACGGCTGTACC
AACGTTAATGG -> ACGTTAATGGG
AACTAGACGTA -> ACTAGACGTAG
AACTAGATGAC -> ACTAGATGACC
AACTATTTGCT -> ACTATTTGCTT
AACTCATACCC -> ACTCATACCCA
AACTCCACACA -> ACTCCACACAT
AAGAAGTGCGT -> AGAAGTGCGTG
AAGAAGTGGCA -> AGAAGTGGCAG
AAGACAACCAC -> AGACAACCACA
AAGACCCTCAC -> AGACCCTCACA
AAGAGATGACA -> AGAGATGACAC
AAGATACGGCC -> AGATACGGCCA
AAGATCGGCAG -> AGATCGGCAGG
AAGCACATCCT -> AGCACATCCTT
AAGCACGCCCC -> AGCACGCCCCA
AAGCACTGAAC -> AGCACTGAACG
AAGCCCTTCTA -> AGCCCTTCTAG
AAGCGAGGTTT -> AGCGAGGTTTT
AAGCGCAAAGC -> AGCGCAAAGCA
AAGCGTTGATT -> AGCGTTGATTA
AAGCTATCTAA -> AGCTATCTAAC
AAGGCCGTAAC -> AGGCCGTAACC
AAGGCCTGTTA -> AGGCCTGTTAA
AAGGCTCGGGA -> AGGCTCGGGAT
AAGGGAAGTGC -> AGGGAAGTGCC
AAGGGCTTAAT -> AGGGCTTAATT
AAGTAACCAAG -> AGTAACCAAGT
AAGTGAAATAC -> AGTGAAATACC
AAGTGCAGGCC -> AGTGCAGGCCG
AAGTGCCGATC -> AGTGCCGATCC
AAGTGCGTGAT -> AGTGCGTGATT
AAGTGCTATTG -> AGTGCTATTGC
AAGTGGCAGTG -> AGTGGCAGTGA
AAGTTAATATG -> AGTTAATATGT
AAGTTCCAGTG -> AGTTCCAGTGG
AAGTTTTTAGG -> AGTTTTTAGGA
AATAAAATCGA -> ATAAAATCGAT
AATAAACAGCC -> ATAAACAGCCC
AATAACGACCG -> ATAACGACCGA
AATACATTATT -> ATACATTATTA
AATACCCTCTC -> ATACCCTCTCC
AATAGAGCCGT -> ATAGAGCCGTA
AATAGAGCTAG -> ATAGAGCTAGA
AATAGCACCCC -> ATAGCACCCCG
AATATGTTTGA -> ATATGTTTGAG
AATCCCGACAT -> ATCCCGACATT
AATCCGACTTG -> ATCCGACTTGC
AATCCGTGTGT -> ATCCGTGTGTC
AATCGACTCGG -> ATCGACTCGGA
AATCGAGTTGA -> ATCGAGTTGAT
AATCGATACGC -> ATCGATACGCC
AATCGGGAAAG -> ATCGGGAAAGT
AATCTACCTTA -> ATCTACCTTAC
AATGCCCAATG -> ATGCCCAATGC
AATGCCCCAAA -> ATGCCCCAAAG
AATGCGCAAGC -> ATGCGCAAGCG
AATGGCTCCCA -> ATGGCTCCCAA
AATGGCTCCCC -> ATGGCTCCCCA
AATGGGTCCTC -> ATGGGTCCTCA
AATGTACTACC -> ATGTACTACCC
AATTACACACA -> ATTACACACAA
AATTACAGCGT -> ATTACAGCGTT
AATTACCTTCG -> ATTACCTTCGG
AATTATCACTT -> ATTATCACTTA
AATTCTCTCAG -> ATTCTCTCAGG
AATTGCCCGAT -> ATTGCCCGATC
AATTGGTGGCT -> ATTGGTGGCTC
AATTGTCTTGT -> ATTGTCTTGTT
AATTTCGTACG -> ATTTCGTACGG
ACAAAGGGCTT -> CAAAGGGCTTA
ACAAATTATCA -> CAAATTATCAC
ACAACACAACG -> CAACACAACGC
ACAACCACAAC -> CAACCACAACA
ACAACGCTACC -> CAACGCTACCC
ACAACTAGATG -> CAACTAGATGA
ACAATCCGTGT -> CAATCCGTGTG
ACAATTACACA -> CAATTACACAC
ACACAAATTAT -> CACAAATTATC
ACACAACGCTA -> CACAACGCTAC
ACACACAAATT -> CACACAAATTA
ACACATTGGAC -> CACATTGGACC
ACACCGCGGAC -> CACCGCGGACC
ACACGACAGGC -> CACGACAGGCC
ACACGCACAGG -> CACGCACAGGG
ACACGGGAATT -> CACGGGAATTG
ACACTGCCATT -> CACTGCCATTG
ACAGCAAGACA -> CAGCAAGACAA
ACAGCATAACC -> CAGCATAACCA
ACAGCCCGAAA -> CAGCCCGAAAG
ACAGCGTTGAA -> CAGCGTTGAAA
ACAGGCCCCGA -> CAGGCCCCGAA
ACAGGGTGCCA -> CAGGGTGCCAC
ACAGTCTTTGC -> CAGTCTTTGCT
ACAGTGTATGT -> CAGTGTATGTT
ACATAAAATCC -> CATAAAATCCG
ACATAGAATAG -> CATAGAATAGA
ACATCCTTCCT -> CATCCTTCCTA
ACATCTAGCAA -> CATCTAGCAAT
ACATCTAGCCA -> CATCTAGCCAC
ACATGTAACTC -> CATGTAACTCA
ACATGTAGGAT -> CATGTAGGATC
ACATTATTAGG -> CATTATTAGGC
ACATTGGACCG -> CATTGGACCGA
ACATTGGAGCA -> CATTGGAGCAC
ACATTTAAAGT -> CATTTAAAGTT
ACCAAAGGCCT -> CCAAAGGCCTG
ACCAACCGAGC -> CCAACCGAGCT
ACCAAGTTAAT -> CCAAGTTAATA
ACCACAACACA -> CCACAACACAA
ACCACCACGGC -> CCACCACGGCT
ACCACGGCTAC -> CCACGGCTACA
ACCACTTCGCT -> CCACTTCGCTT
ACCAGACCTTG -> CCAGACCTTGC
ACCAGACTTGC -> CCAGACTTGCT
ACCATGTCGCA -> CCATGTCGCAC
ACCCAATAAAA -> CCCAATAAAAT
ACCCAATCTAC -> CCCAATCTACC
ACCCATAATCG -> CCCATAATCGA
ACCCATCCCGA -> CCCATCCCGAC
ACCCCCGTTTG -> CCCCCGTTTGA
ACCCCGGAACC -> CCCCGGAACCC
ACCCCTAACGA -> CCCCTAACGAC
ACCCCTTGTTA -> CCCCTTGTTAG
ACCCGACATCT -> CCCGACATCTA
ACCCGAGCACA -> CCCGAGCACAG
ACCCGCTAAGG -> CCCGCTAAGGG
ACCCGGCACGA -> CCCGGCACGAC
ACCCGTGCTCC -> CCCGTGCTCCC
ACCCTCACAAT -> CCCTCACAATT
ACCCTCGCAGG -> CCCTCGCAGGG
ACCCTCTCCCG -> CCCTCTCCCGT
ACCGAAGCACG -> CCGAAGCACGC
ACCGAATGTAC -> CCGAATGTACT
ACCGACCGCCG -> CCGACCGCCGC
ACCGAGCGCTA -> CCGAGCGCTAT
ACCGAGCTAAT -> CCGAGCTAATC
ACCGATCGTAA -> CCGATCGTAAG
ACCGCCGCCAA -> CCGCCGCCAAG
ACCGCGGACCG -> CCGCGGACCGG
ACCGGCGTCCG -> CCGGCGTCCGA
ACCGGGAGGCC -> CCGGGAGGCCC
ACCGTTGGTCC -> CCGTTGGTCCC
ACCGTTTAATT -> CCGTTTAATTT
ACCTACGGTGA -> CCTACGGTGAC
ACCTCAGCGGC -> CCTCAGCGGCC
ACCTCGCGCGC -> CCTCGCGCGCG
ACCTGCCCACC -> CCTGCCCACCA
ACCTTACCGAG -> CCTTACCGAGC
ACCTTCGGCGA -> CCTTCGGCGAC
ACCTTGCGATA -> CCTTGCGATAA
ACGAAACATTT -> CGAAACATTTA
ACGAACCCGAG -> CGAACCCGAGC
ACGAATAGAGC -> CGAATAGAGCT
ACGAATAGCAC -> CGAATAGCACC
ACGACAGGCCC -> CGACAGGCCCC
ACGACATCTAG -> CGACATCTAGC
ACGACCCGTGC -> CGACCCGTGCT
ACGACCCTCGC -> CGACCCTCGCA
ACGACCGATCG -> CGACCGATCGT
ACGACCGTTGG -> CGACCGTTGGT
ACGAGGTCTTT -> CGAGGTCTTTA
ACGCACAGGGT -> CGCACAGGGTG
ACGCAGCGATG -> CGCAGCGATGG
ACGCAGTAGAA -> CGCAGTAGAAG
ACGCCCCACGA -> CGCCCCACGAC
ACGCCGATAAC -> CGCCGATAACG
ACGCCTGGTAT -> CGCCTGGTATC
ACGCGATCGCT -> CGCGATCGCTC
ACGCGTTTGTT -> CGCGTTTGTTC
ACGCTACCCCT -> CGCTACCCCTA
ACGCTGAAAGC -> CGCTGAAAGCT
ACGCTGATAGT -> CGCTGATAGTT
ACGGACTGAAA -> CGGACTGAAAA
ACGGATCCCCT -> CGGATCCCCTA
ACGGCCACGAA -> CGGCCACGAAC
ACGGCTACATG -> CGGCTACATGT
ACGGCTGTACC -> CGGCTGTACCG
ACGGGAATTGC -> CGGGAATTGCC
ACGGGTGGAGA -> CGGGTGGAGAC
ACGGTGACACG -> CGGTGACACGA
ACGTAGTTAAG -> CGTAGTTAAGC
ACGTGGATGCG -> CGTGGATGCGC
ACGTGTGAGGT -> CGTGTGAGGTC
ACGTTAATGGG -> CGTTAATGGGT
ACTAAACGCTG -> CTAAACGCTGA
ACTACCCGCTA -> CTACCCGCTAA
ACTAGACGTAG -> CTAGACGTAGT
ACTAGATACAC -> CTAGATACACT
ACTAGATGACC -> CTAGATGACCC
ACTAGATGCTT -> CTAGATGCTTT
ACTATTTGCTT -> CTATTTGCTTA
ACTCATACCCA -> CTCATACCCAA
ACTCCACACAT -> CTCCACACATT
ACTCGCTCGAA -> CTCGCTCGAAC
ACTCGGAGGGA -> CTCGGAGGGAT
ACTCTCTACTA -> CTCTCTACTAG
ACTGAAAAATG -> CTGAAAAATGC
ACTGAACGTTA -> CTGAACGTTAA
ACTGAGGGGGT -> CTGAGGGGGTT
ACTGCAGATAG -> CTGCAGATAGA
ACTGCCCCAGC -> CTGCCCCAGCG
ACTGCGCTGAC -> CTGCGCTGACG
ACTGGGTCGGT -> CTGGGTCGGTT
ACTTAGGACTC -> CTTAGGACTCG
ACTTATGGACC -> CTTATGGACCA
ACTTCGCTTAT -> CTTCGCTTATA
ACTTCTGCCGT -> CTTCTGCCGTA
ACTTGCGGACA -> CTTGCGGACAG
ACTTGCTATCA -> CTTGCTATCAA
ACTTTCGTCCT -> CTTTCGTCCTG
AGAAGCGCAAA -> GAAGCGCAAAG
AGAAGTGCAGG -> GAAGTGCAGGC
AGAAGTGCGTG -> GAAGTGCGTGA
AGAAGTGGCAG -> GAAGTGGCAGT
AGAATAAACAG -> GAATAAACAGC
AGAATAGAGCC -> GAATAGAGCCG
AGACAACCACA -> GACAACCACAA
AGACAGCAAGA -> GACAGCAAGAC
AGACCAACCGA -> GACCAACCGAG
AGACCCTCACA -> GACCCTCACAA
AGACCTCGCGC -> GACCTCGCGCG
AGACCTTGCGA -> GACCTTGCGAT
AGACGAAACAT -> GACGAAACATT
AGACGTAGTTA -> GACGTAGTTAA
AGACGTGGATG -> GACGTGGATGC
AGACTAGATAC -> GACTAGATACA
AGACTTGCTAT -> GACTTGCTATC
AGAGAGATGAG -> GAGAGATGAGA
AGAGATCGGTC -> GAGATCGGTCT
AGAGATGACAC -> GAGATGACACG
AGAGATGAGAC -> GAGATGAGACG
AGAGCCGTAAA -> GAGCCGTAAAA
AGAGCTAGAAT -> GAGCTAGAATA
AGAGCTTCCGC -> GAGCTTCCGCT
AGATACACTGC -> GATACACTGCC
AGATACGGCCA -> GATACGGCCAC
AGATAGACGTG -> GATAGACGTGG
AGATCGAAATT -> GATCGAAATTA
AGATCGGCAGG -> GATCGGCAGGT
AGATCGGTCTT -> GATCGGTCTTT
AGATGACACGC -> GATGACACGCA
AGATGACCCCT -> GATGACCCCTT
AGATGAGACGA -> GATGAGACGAA
AGATGCTTTTA -> GATGCTTTTAG
AGATTAGAGAG -> GATTAGAGAGA
AGATTGCGACT -> GATTGCGACTG
AGCAAGACAAC -> GCAAGACAACC
AGCAATGGCTC -> GCAATGGCTCC
AGCACAAAGGG -> GCACAAAGGGC
AGCACAGCATA -> GCACAGCATAA
AGCACATCCTT -> GCACATCCTTC
AGCACCATGTC -> GCACCATGTCG
AGCACCCCGGA -> GCACCCCGGAA
AGCACGCCCCA -> GCACGCCCCAC
AGCACTGAACG -> GCACTGAACGT
AGCATAACCAG -> GCATAACCAGA
AGCCACCTCAG -> GCCACCTCAGC
AGCCACTTTCG -> GCCACTTTCGT
AGCCCGAAAGA -> GCCCGAAAGAG
AGCCCGTCCGA -> GCCCGTCCGAA
AGCCCTGATTG -> GCCCTGATTGC
AGCCCTTCTAG -> GCCCTTCTAGA
AGCCGTAAAAA -> GCCGTAAAAAG
AGCGAGGTTTT -> GCGAGGTTTTT
AGCGATGGAGG -> GCGATGGAGGA
AGCGCAAAGCA -> GCGCAAAGCAC
AGCGCTATCTC -> GCGCTATCTCT
AGCGGCACATA -> GCGGCACATAA
AGCGGCCTACC -> GCGGCCTACCC
AGCGGGCCTGG -> GCGGGCCTGGT
AGCGTGTATGG -> GCGTGTATGGG
AGCGTTGAAAA -> GCGTTGAAAAA
AGCGTTGATTA -> GCGTTGATTAA
AGCTAATCGGG -> GCTAATCGGGA
AGCTAGAATAA -> GCTAGAATAAA
AGCTATCTAAC -> GCTATCTAACG
AGCTTCCGCTG -> GCTTCCGCTGC
AGGAACGGCTG -> GGAACGGCTGT
AGGACTCGCTC -> GGACTCGCTCG
AGGAGCCCGTC -> GGAGCCCGTCC
AGGATCGACGA -> GGATCGACGAA
AGGATCGACGG -> GGATCGACGGA
AGGCCAGTCCT -> GGCCAGTCCTA
AGGCCCCGAAT -> GGCCCCGAATC
AGGCCCCGGCT -> GGCCCCGGCTA
AGGCCGAAGCG -> GGCCGAAGCGA
AGGCCGTAACC -> GGCCGTAACCG
AGGCCTGTTAA -> GGCCTGTTAAA
AGGCTCGGGAT -> GGCTCGGGATG
AGGGAAGTGCC -> GGGAAGTGCCG
AGGGAGGGTAG -> GGGAGGGTAGC
AGGGATTCTGC -> GGGATTCTGCT
AGGGCTTAATT -> GGGCTTAATTC
AGGGGCTCATC -> GGGGCTCATCA
AGGGGGTTTCG -> GGGGGTTTCGA
AGGGTAGCCAC -> GGGTAGCCACT
AGGGTGCCACT -> GGGTGCCACTG
AGGGTTACACG -> GGGTTACACGG
AGGTCTAGGTG -> GGTCTAGGTGG
AGGTCTTGCAC -> GGTCTTGCACT
AGGTCTTTACG -> GGTCTTTACGC
AGGTGGGAGCG -> GGTGGGAGCGG
AGGTTTTTTCA -> GGTTTTTTCAT
AGTAACCAAGT -> GTAACCAAGTT
AGTACCTACGG -> GTACCTACGGT
AGTAGAAGTGC -> GTAGAAGTGCA
AGTAGCGTGTA -> GTAGCGTGTAT
AGTATCCGCGC -> GTATCCGCGCC
AGTCCTAGAGA -> GTCCTAGAGAT
AGTCGAGGGAG -> GTCGAGGGAGG
AGTCTTTATCG -> GTCTTTATCGT
AGTCTTTGCTA -> GTCTTTGCTAA
AGTGAAATACC -> GTGAAATACCC
AGTGATCGTGG -> GTGATCGTGGC
AGTGATTACGT -> GTGATTACGTG
AGTGCAGGCCG -> GTGCAGGCCGA
AGTGCCGATCC -> GTGCCGATCCA
AGTGCGTGATT -> GTGCGTGATTC
AGTGCTATTGC -> GTGCTATTGCA
AGTGGCACTTA -> GTGGCACTTAG
AGTGGCAGTGA -> GTGGCAGTGAT
AGTGGCGAAAT -> GTGGCGAAATA
AGTGGTATAGT -> GTGGTATAGTA
AGTGTATGTTT -> GTGTATGTTTC
AGTTAAGCACA -> GTTAAGCACAT
AGTTAATATGT -> GTTAATATGTT
AGTTCATGGGG -> GTTCATGGGGT
AGTTCCAGTGG -> GTTCCAGTGGT
AGTTGATTATC -> GTTGATTATCG
AGTTGATTATG -> GTTGATTATGG
AGTTTTTAGGA -> GTTTTTAGGAT
ATAAAATCCGA -> TAAAATCCGAC
ATAAAATCGAT -> TAAAATCGATA
ATAAACAGCCC -> TAAACAGCCCG
ATAACCAGACC -> TAACCAGACCT
ATAACGACCGA -> TAACGACCGAT
ATAACGCAGCG -> TAACGCAGCGA
ATAATCCCGAC -> TAATCCCGACA
ATAATCGACTC -> TAATCGACTCG
ATACACTGCCA -> TACACTGCCAT
ATACATTATTA -> TACATTATTAG
ATACCCAATAA -> TACCCAATAAA
ATACCCATCCC -> TACCCATCCCG
ATACCCGACAT -> TACCCGACATC
ATACCCTCTCC -> TACCCTCTCCC
ATACGCCGATA -> TACGCCGATAA
ATACGCTGATA -> TACGCTGATAG
ATACGGCCACG -> TACGGCCACGA
ATAGAATAGAG -> TAGAATAGAGC
ATAGACGTGGA -> TAGACGTGGAT
ATAGAGCCGTA -> TAGAGCCGTAA
ATAGAGCTAGA -> TAGAGCTAGAA
ATAGCACCCCG -> TAGCACCCCGG
ATAGTATCCGC -> TAGTATCCGCG
ATAGTGGCGAA -> TAGTGGCGAAA
ATAGTTGATTA -> TAGTTGATTAT
ATATGGCGATC -> TATGGCGATCG
ATATGTTTGAG -> TATGTTTGAGT
ATATTCACTTC -> TATTCACTTCT
ATCAAGATACG -> TCAAGATACGG
ATCAAGGCTCG -> TCAAGGCTCGG
ATCACTTATGG -> TCACTTATGGA
ATCAGATCGAA -> TCAGATCGAAA
ATCCACTGGGT -> TCCACTGGGTC
ATCCCCTAGAT -> TCCCCTAGATT
ATCCCGACATA -> TCCCGACATAG
ATCCCGACATT -> TCCCGACATTG
ATCCGACTTGC -> TCCGACTTGCG
ATCCGCGCCTG -> TCCGCGCCTGT
ATCCGTGTGTC -> TCCGTGTGTCC
ATCCTGCGCAA -> TCCTGCGCAAC
ATCCTTCCTAT -> TCCTTCCTATG
ATCGAAATTAC -> TCGAAATTACC
ATCGACGAATA -> TCGACGAATAG
ATCGACGGACT -> TCGACGGACTG
ATCGACTCGGA -> TCGACTCGGAG
ATCGAGTTGAT -> TCGAGTTGATT
ATCGATACGCC -> TCGATACGCCG
ATCGCGTCCCA -> TCGCGTCCCAC
ATCGCTCGAGA -> TCGCTCGAGAA
ATCGGCAGGTC -> TCGGCAGGTCT
ATCGGGAAAGT -> TCGGGAAAGTT
ATCGGGCACGC -> TCGGGCACGCA
ATCGGTCTTTG -> TCGGTCTTTGC
ATCGTAAGTGC -> TCGTAAGTGCT
ATCGTGGCTAG -> TCGTGGCTAGA
ATCGTTAATGG -> TCGTTAATGGC
ATCGTTTTCGG -> TCGTTTTCGGG
ATCTAACGGAT -> TCTAACGGATC
ATCTACCTTAC -> TCTACCTTACC
ATCTAGCAATG -> TCTAGCAATGG
ATCTAGCCACC -> TCTAGCCACCT
ATCTCCTTTTG -> TCTCCTTTTGT
ATCTCTGGGCA -> TCTCTGGGCAA
ATGACACGCAC -> TGACACGCACA
ATGACCCCTTG -> TGACCCCTTGT
ATGAGACGAAA -> TGAGACGAAAC
ATGCCCAATGC -> TGCCCAATGCC
ATGCCCCAAAG -> TGCCCCAAAGT
ATGCGCAAGCG -> TGCGCAAGCGT
ATGCGCATTCT -> TGCGCATTCTA
ATGCGCTAGCA -> TGCGCTAGCAC
ATGCTTTTAGT -> TGCTTTTAGTA
ATGGACCACCA -> TGGACCACCAC
ATGGAGGAACG -> TGGAGGAACGG
ATGGCGATCGG -> TGGCGATCGGG
ATGGCTCCCAA -> TGGCTCCCAAT
ATGGCTCCCCA -> TGGCTCCCCAC
ATGGGCGAGTG -> TGGGCGAGTGG
ATGGGGAGTCG -> TGGGGAGTCGA
ATGGGGTGCGT -> TGGGGTGCGTG
ATGGGTCCTCA -> TGGGTCCTCAG
ATGGTCGAACC -> TGGTCGAACCG
ATGTAAAACAT -> TGTAAAACATG
ATGTAAAGGCC -> TGTAAAGGCCG
ATGTAACTCAT -> TGTAACTCATA
ATGTACTACCC -> TGTACTACCCG
ATGTAGGATCG -> TGTAGGATCGA
ATGTCGCACAG -> TGTCGCACAGT
ATGTTTCGTGG -> TGTTTCGTGGT
ATGTTTGAGTT -> TGTTTGAGTTC
ATTAACCGGCG -> TTAACCGGCGT
ATTACACACAA -> TTACACACAAA
ATTACAGCGTT -> TTACAGCGTTG
ATTACCTTCGG -> TTACCTTCGGC
ATTACGTGTGA -> TTACGTGTGAG
ATTAGAGAGAT -> TTAGAGAGATG
ATTAGGCCAGT -> TTAGGCCAGTC
ATTATCACTTA -> TTATCACTTAT
ATTATCGCGTC -> TTATCGCGTCC
ATTATGGGGAG -> TTATGGGGAGT
ATTATTAGGCC -> TTATTAGGCCA
ATTCACTTCTG -> TTCACTTCTGC
ATTCTAAGTGA -> TTCTAAGTGAA
ATTCTCATATT -> TTCTCATATTC
ATTCTCTCAGG -> TTCTCTCAGGG
ATTCTGCTGTA -> TTCTGCTGTAT
ATTGCATCGTT -> TTGCATCGTTT
ATTGCCCGATC -> TTGCCCGATCC
ATTGCGACTGC -> TTGCGACTGCG
ATTGCGATACC -> TTGCGATACCC
ATTGGACCGAC -> TTGGACCGACC
ATTGGAGCACC -> TTGGAGCACCA
ATTGGTGGCTC -> TTGGTGGCTCG
ATTGTCTTGTT -> TTGTCTTGTTA
ATTTAAAGTTC -> TTTAAAGTTCC
ATTTCGTACGG -> TTTCGTACGGG
ATTTGCTTAGG -> TTTGCTTAGGA
CAAAGCACTGA -> AAAGCACTGAA
CAAAGGCCTGT -> AAAGGCCTGTT
CAAAGGGCTTA -> AAAGGGCTTAA
CAAAGTAACCA -> AAAGTAACCAA
CAAATTATCAC -> AAATTATCACT
CAACACAACGC -> AACACAACGCT
CAACCACAACA -> AACCACAACAC
CAACCCAATCT -> AACCCAATCTA
CAACCGAGCTA -> AACCGAGCTAA
CAACGCTACCC -> AACGCTACCCC
CAACTAGATGA -> AACTAGATGAC
CAACTCCACAC -> AACTCCACACA
CAAGACAACCA -> AAGACAACCAC
CAAGACCCTCA -> AAGACCCTCAC
CAAGATACGGC -> AAGATACGGCC
CAAGCGTTGAT -> AAGCGTTGATT
CAAGGCTCGGG -> AAGGCTCGGGA
CAAGTTAATAT -> AAGTTAATATG
CAATAAAATCG -> AATAAAATCGA
CAATACATTAT -> AATACATTATT
CAATCCGTGTG -> AATCCGTGTGT
CAATCTACCTT -> AATCTACCTTA
CAATGCCCAAT -> AATGCCCAATG
CAATGCCCCAA -> AATGCCCCAAA
CAATGGCTCCC -> AATGGCTCCCA
CAATTACACAC -> AATTACACACA
CAATTGGTGGC -> AATTGGTGGCT
CACAAAGGGCT -> ACAAAGGGCTT
CACAAATTATC -> ACAAATTATCA
CACAACACAAC -> ACAACACAACG
CACAACGCTAC -> ACAACGCTACC
CACAATTACAC -> ACAATTACACA
CACACAAATTA -> ACACAAATTAT
CACACATTGGA -> ACACATTGGAC
CACACCGCGGA -> ACACCGCGGAC
CACAGCATAAC -> ACAGCATAACC
CACAGGGTGCC -> ACAGGGTGCCA
CACAGTCTTTG -> ACAGTCTTTGC
CACATAAAATC -> ACATAAAATCC
CACATCCTTCC -> ACATCCTTCCT
CACATTGGACC -> ACATTGGACCG
CACCACGGCTA -> ACCACGGCTAC
CACCACTTCGC -> ACCACTTCGCT
CACCATGTCGC -> ACCATGTCGCA
CACCCCGGAAC -> ACCCCGGAACC
CACCGCGGACC -> ACCGCGGACCG
CACCTCAGCGG -> ACCTCAGCGGC
CACCTGCCCAC -> ACCTGCCCACC
CACGAACCCGA -> ACGAACCCGAG
CACGACAGGCC -> ACGACAGGCCC
CACGACCCTCG -> ACGACCCTCGC
CACGACCGTTG -> ACGACCGTTGG
CACGAGGTCTT -> ACGAGGTCTTT
CACGCACAGGG -> ACGCACAGGGT
CACGCAGTAGA -> ACGCAGTAGAA
CACGCCCCACG -> ACGCCCCACGA
CACGGCTACAT -> ACGGCTACATG
CACGGGAATTG -> ACGGGAATTGC
CACTCTCTACT -> ACTCTCTACTA
CACTGAACGTT -> ACTGAACGTTA
CACTGCAGATA -> ACTGCAGATAG
CACTGCCATTG -> ACTGCCATTGA
CACTGCCCCAG -> ACTGCCCCAGC
CACTGGGTCGG -> ACTGGGTCGGT
CACTTAGGACT -> ACTTAGGACTC
CACTTATGGAC -> ACTTATGGACC
CACTTCGCTTA -> ACTTCGCTTAT
CACTTCTGCCG -> ACTTCTGCCGT
CACTTTCGTCC -> ACTTTCGTCCT
CAGACCTTGCG -> AGACCTTGCGA
CAGACTTGCTA -> AGACTTGCTAT
CAGATAGACGT -> AGATAGACGTG
CAGATCGAAAT -> AGATCGAAATT
CAGCAAGACAA -> AGCAAGACAAC
CAGCATAACCA -> AGCATAACCAG
CAGCCCGAAAG -> AGCCCGAAAGA
CAGCGATGGAG -> AGCGATGGAGG
CAGCGGCCTAC -> AGCGGCCTACC
CAGCGGGCCTG -> AGCGGGCCTGG
CAGCGTTGAAA -> AGCGTTGAAAA
CAGGCCCCGAA -> AGGCCCCGAAT
CAGGCCGAAGC -> AGGCCGAAGCG
CAGGGGCTCAT -> AGGGGCTCATC
CAGGGTGCCAC -> AGGGTGCCACT
CAGGGTTACAC -> AGGGTTACACG
CAGGTCTAGGT -> AGGTCTAGGTG
CAGTAGAAGTG -> AGTAGAAGTGC
CAGTAGCGTGT -> AGTAGCGTGTA
CAGTCCTAGAG -> AGTCCTAGAGA
CAGTCTTTATC -> AGTCTTTATCG
CAGTCTTTGCT -> AGTCTTTGCTA
CAGTGATCGTG -> AGTGATCGTGG
CAGTGATTACG -> AGTGATTACGT
CAGTGGTATAG -> AGTGGTATAGT
CAGTGTATGTT -> AGTGTATGTTT
CATAAAATCCG -> ATAAAATCCGA
CATAACCAGAC -> ATAACCAGACC
CATAATCGACT -> ATAATCGACTC
CATACCCAATA -> ATACCCAATAA
CATAGAATAGA -> ATAGAATAGAG
CATAGTGGCGA -> ATAGTGGCGAA
CATATTCACTT -> ATATTCACTTC
CATCAGATCGA -> ATCAGATCGAA
CATCCCGACAT -> ATCCCGACATA
CATCCTTCCTA -> ATCCTTCCTAT
CATCGTTTTCG -> ATCGTTTTCGG
CATCTAGCAAT -> ATCTAGCAATG
CATCTAGCCAC -> ATCTAGCCACC
CATGGGGTGCG -> ATGGGGTGCGT
CATGGTCGAAC -> ATGGTCGAACC
CATGTAACTCA -> ATGTAACTCAT
CATGTAGGATC -> ATGTAGGATCG
CATGTCGCACA -> ATGTCGCACAG
CATTATTAGGC -> ATTATTAGGCC
CATTCTAAGTG -> ATTCTAAGTGA
CATTGGACCGA -> ATTGGACCGAC
CATTGGAGCAC -> ATTGGAGCACC
CATTTAAAGTT -> ATTTAAAGTTC
CCAAAGGCCTG -> CAAAGGCCTGT
CCAAAGTAACC -> CAAAGTAACCA
CCAACCGAGCT -> CAACCGAGCTA
CCAAGACCCTC -> CAAGACCCTCA
CCAAGTTAATA -> CAAGTTAATAT
CCAATAAAATC -> CAATAAAATCG
CCAATACATTA -> CAATACATTAT
CCAATCTACCT -> CAATCTACCTT
CCAATGCCCCA -> CAATGCCCCAA
CCACAACACAA -> CACAACACAAC
CCACACATTGG -> CACACATTGGA
CCACCACGGCT -> CACCACGGCTA
CCACCACTTCG -> CACCACTTCGC
CCACCTCAGCG -> CACCTCAGCGG
CCACCTGCCCA -> CACCTGCCCAC
CCACGAACCCG -> CACGAACCCGA
CCACGACCGTT -> CACGACCGTTG
CCACGAGGTCT -> CACGAGGTCTT
CCACGGCTACA -> CACGGCTACAT
CCACTGCAGAT -> CACTGCAGATA
CCACTGCCCCA -> CACTGCCCCAG
CCACTGGGTCG -> CACTGGGTCGG
CCACTTCGCTT -> CACTTCGCTTA
CCACTTTCGTC -> CACTTTCGTCC
CCAGACCTTGC -> CAGACCTTGCG
CCAGACTTGCT -> CAGACTTGCTA
CCAGCGGGCCT -> CAGCGGGCCTG
CCAGTCCTAGA -> CAGTCCTAGAG
CCAGTGATCGT -> CAGTGATCGTG
CCAGTGGTATA -> CAGTGGTATAG
CCATAATCGAC -> CATAATCGACT
CCATAGTGGCG -> CATAGTGGCGA
CCATCCCGACA -> CATCCCGACAT
CCATGTCGCAC -> CATGTCGCACA
CCCAAAGTAAC -> CCAAAGTAACC
CCCAATAAAAT -> CCAATAAAATC
CCCAATACATT -> CCAATACATTA
CCCAATCTACC -> CCAATCTACCT
CCCAATGCCCC -> CCAATGCCCCA
CCCACCACTTC -> CCACCACTTCG
CCCACGACCGT -> CCACGACCGTT
CCCACGAGGTC -> CCACGAGGTCT
CCCACTGCCCC -> CCACTGCCCCA
CCCAGCGGGCC -> CCAGCGGGCCT
CCCAGTGATCG -> CCAGTGATCGT
CCCATAATCGA -> CCATAATCGAC
CCCATAGTGGC -> CCATAGTGGCG
CCCATCCCGAC -> CCATCCCGACA
CCCCAAAGTAA -> CCCAAAGTAAC
CCCCACGACCG -> CCCACGACCGT
CCCCACGAGGT -> CCCACGAGGTC
CCCCAGCGGGC -> CCCAGCGGGCC
CCCCCGTTTGA -> CCCCGTTTGAC
CCCCGAATCGA -> CCCGAATCGAG
CCCCGGAACCC -> CCCGGAACCCG
CCCCGGCTATC -> CCCGGCTATCT
CCCCGTTTGAC -> CCCGTTTGACG
CCCCTAACGAC -> CCCTAACGACA
CCCCTAGATTA -> CCCTAGATTAG
CCCCTTGTTAG -> CCCTTGTTAGC
CCCGAAAGAGA -> CCGAAAGAGAT
CCCGAATCGAG -> CCGAATCGAGT
CCCGACATAGA -> CCGACATAGAA
CCCGACATCTA -> CCGACATCTAG
CCCGACATTGG -> CCGACATTGGA
CCCGACCAAAG -> CCGACCAAAGG
CCCGAGCACAG -> CCGAGCACAGC
CCCGATCCTGC -> CCGATCCTGCG
CCCGCTAAGGG -> CCGCTAAGGGA
CCCGGAACCCG -> CCGGAACCCGG
CCCGGAGATTG -> CCGGAGATTGC
CCCGGCACGAC -> CCGGCACGACC
CCCGGCTATCT -> CCGGCTATCTC
CCCGTCCGAAT -> CCGTCCGAATT
CCCGTCGCAAT -> CCGTCGCAATT
CCCGTGCTCCC -> CCGTGCTCCCA
CCCGTGTTCAA -> CCGTGTTCAAT
CCCGTTTGACG -> CCGTTTGACGA
CCCTAACGACA -> CCTAACGACAT
CCCTAGATTAG -> CCTAGATTAGA
CCCTCACAATT -> CCTCACAATTA
CCCTCGCAGGG -> CCTCGCAGGGG
CCCTCTCCCGT -> CCTCTCCCGTC
CCCTGATTGCG -> CCTGATTGCGA
CCCTTCTAGAC -> CCTTCTAGACC
CCCTTGTTAGC -> CCTTGTTAGCC
CCGAAAGAGAT -> CGAAAGAGATG
CCGAAATTACA -> CGAAATTACAG
CCGAAGCACGC -> CGAAGCACGCC
CCGAAGCGAGG -> CGAAGCGAGGT
CCGAATCGAGT -> CGAATCGAGTT
CCGAATGTACT -> CGAATGTACTA
CCGAATTGTCT -> CGAATTGTCTT
CCGACATAGAA -> CGACATAGAAT
CCGACATCTAG -> CGACATCTAGC
CCGACATTGGA -> CGACATTGGAG
CCGACCAAAGG -> CGACCAAAGGC
CCGACCGCCGC -> CGACCGCCGCC
CCGACTTGCGG -> CGACTTGCGGA
CCGAGCACAGC -> CGAGCACAGCA
CCGAGCGCTAT -> CGAGCGCTATC
CCGAGCTAATC -> CGAGCTAATCG
CCGATAACGCA -> CGATAACGCAG
CCGATCCACTG -> CGATCCACTGG
CCGATCCTGCG -> CGATCCTGCGC
CCGATCGTAAG -> CGATCGTAAGT
CCGCCAAGACC -> CGCCAAGACCC
CCGCCGCCAAG -> CGCCGCCAAGA
CCGCGCCTGTG -> CGCGCCTGTGA
CCGCGGACCGG -> CGCGGACCGGG
CCGCTAAGGGA -> CGCTAAGGGAA
CCGCTGCCGGC -> CGCTGCCGGCA
CCGGAACCCGG -> CGGAACCCGGC
CCGGAGATTGC -> CGGAGATTGCG
CCGGCACACCG -> CGGCACACCGC
CCGGCACGACC -> CGGCACGACCC
CCGGCGTCCGA -> CGGCGTCCGAA
CCGGCTATCTC -> CGGCTATCTCC
CCGGGAGGCCC -> CGGGAGGCCCC
CCGTAAAAAGA -> CGTAAAAAGAA
CCGTAACCGTT -> CGTAACCGTTT
CCGTAACTAGA -> CGTAACTAGAC
CCGTCCGAATT -> CGTCCGAATTG
CCGTCGCAATT -> CGTCGCAATTG
CCGTCTTTCTC -> CGTCTTTCTCG
CCGTGCTCCCA -> CGTGCTCCCAG
CCGTGTGTCCC -> CGTGTGTCCCA
CCGTGTTCAAT -> CGTGTTCAATG
CCGTTGGTCCC -> CGTTGGTCCCG
CCGTTTAATTT -> CGTTTAATTTC
CCGTTTGACGA -> CGTTTGACGAC
CCTAACGACAT -> CTAACGACATC
CCTACCCATAA -> CTACCCATAAT
CCTACGGTGAC -> CTACGGTGACA
CCTAGACAGCA -> CTAGACAGCAA
CCTAGAGATCG -> CTAGAGATCGG
CCTAGATTAGA -> CTAGATTAGAG
CCTATGTAAAA -> CTATGTAAAAC
CCTCACAATTA -> CTCACAATTAC
CCTCAGCGGCC -> CTCAGCGGCCT
CCTCAGTCTTT -> CTCAGTCTTTA
CCTCGCAGGGG -> CTCGCAGGGGC
CCTCGCGCGCG -> CTCGCGCGCGG
CCTCTCCCGTC -> CTCTCCCGTCG
CCTGACTGAGG -> CTGACTGAGGG
CCTGAGACTAG -> CTGAGACTAGA
CCTGATTGCGA -> CTGATTGCGAT
CCTGCCCACCA -> CTGCCCACCAC
CCTGCGCAACC -> CTGCGCAACCC
CCTGGTATCAA -> CTGGTATCAAG
CCTGGTATGTA -> CTGGTATGTAA
CCTGTGAAGAT -> CTGTGAAGATC
CCTGTTAAAGA -> CTGTTAAAGAA
CCTTACCGAGC -> CTTACCGAGCG
CCTTCCTATGT -> CTTCCTATGTA
CCTTCGGCGAC -> CTTCGGCGACC
CCTTCTAGACC -> CTTCTAGACCT
CCTTGCGATAA -> CTTGCGATAAT
CCTTGTTAGCC -> CTTGTTAGCCC
CCTTTTGTTAC -> CTTTTGTTACG
CGAAACATTTA -> GAAACATTTAA
CGAAAGAGATG -> GAAAGAGATGA
CGAAATAACGA -> GAAATAACGAC
CGAAATTACAG -> GAAATTACAGC
CGAAATTACCT -> GAAATTACCTT
CGAACCAGACT -> GAACCAGACTT
CGAACCCGAGC -> GAACCCGAGCA
CGAACCGAAGC -> GAACCGAAGCA
CGAAGCACGCC -> GAAGCACGCCC
CGAAGCGAGGT -> GAAGCGAGGTT
CGAATAGAGCT -> GAATAGAGCTA
CGAATAGCACC -> GAATAGCACCC
CGAATCGAGTT -> GAATCGAGTTG
CGAATGTACTA -> GAATGTACTAC
CGAATTGTCTT -> GAATTGTCTTG
CGACAGGCCCC -> GACAGGCCCCG
CGACATAGAAT -> GACATAGAATA
CGACATCTAGC -> GACATCTAGCA,GACATCTAGCC
CGACATTGGAG -> GACATTGGAGC
CGACCAAAGGC -> GACCAAAGGCC
CGACCCCCGTT -> GACCCCCGTTT
CGACCCGTGCT -> GACCCGTGCTC
CGACCCTCGCA -> GACCCTCGCAG
CGACCGATCGT -> GACCGATCGTA
CGACCGCCGCC -> GACCGCCGCCA
CGACCGTTGGT -> GACCGTTGGTC
CGACGAATAGC -> GACGAATAGCA
CGACGGACTGA -> GACGGACTGAA
CGACTAAACGC -> GACTAAACGCT
CGACTCGGAGG -> GACTCGGAGGG
CGACTGCGCTG -> GACTGCGCTGA
CGACTTGCGGA -> GACTTGCGGAC
CGAGAAGCGCA -> GAGAAGCGCAA
CGAGCACAGCA -> GAGCACAGCAT
CGAGCGCTATC -> GAGCGCTATCT
CGAGCTAATCG -> GAGCTAATCGG
CGAGGGAGGGT -> GAGGGAGGGTA
CGAGGTCTTTA -> GAGGTCTTTAC
CGAGGTTTTTT -> GAGGTTTTTTC
CGAGTGGCACT -> GAGTGGCACTT
CGAGTTGATTA -> GAGTTGATTAT
CGATAACGCAG -> GATAACGCAGC
CGATAATCCCG -> GATAATCCCGA
CGATACCCATC -> GATACCCATCC
CGATACGCCGA -> GATACGCCGAT
CGATCCACTGG -> GATCCACTGGG
CGATCCTGCGC -> GATCCTGCGCA
CGATCGCTCGA -> GATCGCTCGAG
CGATCGGGCAC -> GATCGGGCACG
CGATCGTAAGT -> GATCGTAAGTG
CGATGGAGGAA -> GATGGAGGAAC
CGCAAAGCACT -> GCAAAGCACTG
CGCAACCCAAT -> GCAACCCAATC
CGCAAGCGTTG -> GCAAGCGTTGA
CGCAATTGGTG -> GCAATTGGTGG
CGCACAGGGTG -> GCACAGGGTGC
CGCACAGTCTT -> GCACAGTCTTT
CGCAGCGATGG -> GCAGCGATGGA
CGCAGGGGCTC -> GCAGGGGCTCA
CGCAGTAGAAG -> GCAGTAGAAGT
CGCATTCTAAG -> GCATTCTAAGT
CGCCAAGACCC -> GCCAAGACCCT
CGCCCCACGAC -> GCCCCACGACC
CGCCGATAACG -> GCCGATAACGC
CGCCGCCAAGA -> GCCGCCAAGAC
CGCCGTCTTTC -> GCCGTCTTTCT
CGCCTGACTGA -> GCCTGACTGAG
CGCCTGGTATC -> GCCTGGTATCA
CGCCTGTGAAG -> GCCTGTGAAGA
CGCGATCGCTC -> GCGATCGCTCG
CGCGCCTGTGA -> GCGCCTGTGAA
CGCGCGCGGTC -> GCGCGCGGTCC
CGCGCGGTCCT -> GCGCGGTCCTA
CGCGGACCGGG -> GCGGACCGGGA
CGCGGTCCTAG -> GCGGTCCTAGA
CGCGTCCCACT -> GCGTCCCACTG
CGCGTTTGTTC -> GCGTTTGTTCG
CGCTAAGGGAA -> GCTAAGGGAAG
CGCTACCCCTA -> GCTACCCCTAA
CGCTAGCACAA -> GCTAGCACAAA
CGCTATCTCTG -> GCTATCTCTGG
CGCTCAGTAGC -> GCTCAGTAGCG
CGCTCGAACCA -> GCTCGAACCAG
CGCTCGAGAAG -> GCTCGAGAAGC
CGCTGAAAGCT -> GCTGAAAGCTA
CGCTGACGCGA -> GCTGACGCGAT
CGCTGATAGTT -> GCTGATAGTTG
CGCTGCCGGCA -> GCTGCCGGCAC
CGCTTATATGG -> GCTTATATGGC
CGGAACCCGGC -> GGAACCCGGCA
CGGACAGTGTA -> GGACAGTGTAT
CGGACCGGGAG -> GGACCGGGAGG
CGGACTGAAAA -> GGACTGAAAAA
CGGAGATTGCG -> GGAGATTGCGA
CGGAGGGATTC -> GGAGGGATTCT
CGGATCCCCTA -> GGATCCCCTAG
CGGCACACCGC -> GGCACACCGCG
CGGCACATAAA -> GGCACATAAAA
CGGCACGACCC -> GGCACGACCCT
CGGCAGGTCTA -> GGCAGGTCTAG
CGGCCACGAAC -> GGCCACGAACC
CGGCCTACCCA -> GGCCTACCCAT
CGGCGACCCCC -> GGCGACCCCCG
CGGCGTCCGAA -> GGCGTCCGAAA
CGGCTACATGT -> GGCTACATGTA
CGGCTATCTCC -> GGCTATCTCCT
CGGCTGTACCG -> GGCTGTACCGA
CGGGAAAGTTT -> GGGAAAGTTTT
CGGGAATTGCC -> GGGAATTGCCC
CGGGAGGCCCC -> GGGAGGCCCCG
CGGGATGCGCA -> GGGATGCGCAT
CGGGCACGCAG -> GGGCACGCAGT
CGGGCCCGTGT -> GGGCCCGTGTT
CGGGCCTGGTA -> GGGCCTGGTAT
CGGGTGGAGAC -> GGGTGGAGACC
CGGTCCTAGAC -> GGTCCTAGACA
CGGTCTTTGCC -> GGTCTTTGCCA
CGGTGACACGA -> GGTGACACGAC
CGGTTATACCC -> GGTTATACCCG
CGTAAAAAGAA -> GTAAAAAGAAG
CGTAACCGTTT -> GTAACCGTTTA
CGTAACTAGAC -> GTAACTAGACG
CGTAAGTGCTA -> GTAAGTGCTAT
CGTACGGGTGG -> GTACGGGTGGA
CGTAGTTAAGC -> GTAGTTAAGCA
CGTCCCACTGC -> GTCCCACTGCC
CGTCCGAAATT -> GTCCGAAATTA
CGTCCGAATTG -> GTCCGAATTGT
CGTCCTGAGAC -> GTCCTGAGACT
CGTCGCAATTG -> GTCGCAATTGG
CGTCTTTCTCG -> GTCTTTCTCGC
CGTGAACTATT -> GTGAACTATTT
CGTGATTCTCA -> GTGATTCTCAT
CGTGCTCCCAG -> GTGCTCCCAGT
CGTGGATGCGC -> GTGGATGCGCT
CGTGGCTAGAG -> GTGGCTAGAGC
CGTGGTTCCCG -> GTGGTTCCCGA
CGTGTATGGGC -> GTGTATGGGCG
CGTGTGAGGTC -> GTGTGAGGTCT
CGTGTGTCCCA -> GTGTGTCCCAT
CGTGTTCAATG -> GTGTTCAATGC
CGTTAATGGCT -> GTTAATGGCTC
CGTTAATGGGT -> GTTAATGGGTC
CGTTGAAAAAC -> GTTGAAAAACG
CGTTGATTAAC -> GTTGATTAACC
CGTTGGTCCCG -> GTTGGTCCCGG
CGTTTAATTTC -> GTTTAATTTCG
CGTTTGACGAC -> GTTTGACGACC
CGTTTGTTCGC -> GTTTGTTCGCT
CGTTTTCGGGC -> GTTTTCGGGCC
CTAAACGCTGA -> TAAACGCTGAA
CTAAAGCCCTT -> TAAAGCCCTTC
CTAACGACATC -> TAACGACATCT
CTAACGGATCC -> TAACGGATCCC
CTAAGGGAAGT -> TAAGGGAAGTG
CTAAGTGAAAT -> TAAGTGAAATA
CTAATCGGGAA -> TAATCGGGAAA
CTACATGTAGG -> TACATGTAGGA
CTACCCATAAT -> TACCCATAATC
CTACCCCTAAC -> TACCCCTAACG
CTACCCGCTAA -> TACCCGCTAAG
CTACCTTACCG -> TACCTTACCGA
CTACGGTGACA -> TACGGTGACAC
CTACTAGATGC -> TACTAGATGCT
CTAGAATAAAC -> TAGAATAAACA
CTAGACAGCAA -> TAGACAGCAAG
CTAGACCTCGC -> TAGACCTCGCG
CTAGACGTAGT -> TAGACGTAGTT
CTAGAGATCGG -> TAGAGATCGGT
CTAGAGCTTCC -> TAGAGCTTCCG
CTAGATACACT -> TAGATACACTG
CTAGATGACCC -> TAGATGACCCC
CTAGATGCTTT -> TAGATGCTTTT
CTAGATTAGAG -> TAGATTAGAGA
CTAGCAATGGC -> TAGCAATGGCT
CTAGCACAAAG -> TAGCACAAAGG
CTAGCCACCTC -> TAGCCACCTCA
CTAGGTGGGAG -> TAGGTGGGAGC
CTATCAAGATA -> TATCAAGATAC
CTATCTAACGG -> TATCTAACGGA
CTATCTCCTTT -> TATCTCCTTTT
CTATCTCTGGG -> TATCTCTGGGC
CTATGTAAAAC -> TATGTAAAACA
CTATTGCATCG -> TATTGCATCGT
CTATTTGCTTA -> TATTTGCTTAG
CTCACAATTAC -> TCACAATTACA
CTCAGCGGCCT -> TCAGCGGCCTA
CTCAGGGTTAC -> TCAGGGTTACA
CTCAGTAGCGT -> TCAGTAGCGTG
CTCAGTCTTTA -> TCAGTCTTTAT
CTCATACCCAA -> TCATACCCAAT
CTCATATTCAC -> TCATATTCACT
CTCATCAGATC -> TCATCAGATCG
CTCCACACATT -> TCCACACATTG
CTCCCAATACA -> TCCCAATACAT
CTCCCAGTGAT -> TCCCAGTGATC
CTCCCCACGAG -> TCCCCACGAGG
CTCCCGTCGCA -> TCCCGTCGCAA
CTCCTTTTGTT -> TCCTTTTGTTA
CTCGAACCAGA -> TCGAACCAGAC
CTCGAGAAGCG -> TCGAGAAGCGC
CTCGCAGGGGC -> TCGCAGGGGCT
CTCGCCGTCTT -> TCGCCGTCTTT
CTCGCCTGACT -> TCGCCTGACTG
CTCGCGCGCGG -> TCGCGCGCGGT
CTCGCTCGAAC -> TCGCTCGAACC
CTCGGAGGGAT -> TCGGAGGGATT
CTCGGGATGCG -> TCGGGATGCGC
CTCTACTAGAT -> TCTACTAGATG
CTCTCAGGGTT -> TCTCAGGGTTA
CTCTCCCGTCG -> TCTCCCGTCGC
CTCTCTACTAG -> TCTCTACTAGA
CTCTGGGCAAC -> TCTGGGCAACT
CTGAAAAATGC -> TGAAAAATGCG
CTGAAAGCTAT -> TGAAAGCTATC
CTGAACGTTAA -> TGAACGTTAAT
CTGACGCGATC -> TGACGCGATCG
CTGACTGAGGG -> TGACTGAGGGG
CTGAGACTAGA -> TGAGACTAGAT
CTGAGGGGGTT -> TGAGGGGGTTT
CTGATAGTTGA -> TGATAGTTGAT
CTGATTGCGAT -> TGATTGCGATA
CTGCAGATAGA -> TGCAGATAGAC
CTGCCCACCAC -> TGCCCACCACT
CTGCCCCAGCG -> TGCCCCAGCGG
CTGCCGGCACA -> TGCCGGCACAC
CTGCCGTAACT -> TGCCGTAACTA
CTGCGCAACCC -> TGCGCAACCCA
CTGCGCTGACG -> TGCGCTGACGC
CTGCTGTATAC -> TGCTGTATACG
CTGGGCAACTC -> TGGGCAACTCC
CTGGGTCGGTT -> TGGGTCGGTTA
CTGGTATCAAG -> TGGTATCAAGG
CTGGTATGTAA -> TGGTATGTAAA
CTGTACCGAAT -> TGTACCGAATG
CTGTATACGCT -> TGTATACGCTG
CTGTGAAGATC -> TGTGAAGATCG
CTGTTAAAGAA -> TGTTAAAGAAG
CTTAATTCTCT -> TTAATTCTCTC
CTTACCGAGCG -> TTACCGAGCGC
CTTAGGACTCG -> TTAGGACTCGC
CTTAGGAGCCC -> TTAGGAGCCCG
CTTATATGGCG -> TTATATGGCGA
CTTATGGACCA -> TTATGGACCAC
CTTCCGCTGCC -> TTCCGCTGCCG
CTTCCTATGTA -> TTCCTATGTAA
CTTCGCTTATA -> TTCGCTTATAT
CTTCGGCGACC -> TTCGGCGACCC
CTTCTAGACCT -> TTCTAGACCTC
CTTCTGCCGTA -> TTCTGCCGTAA
CTTGCACTCTC -> TTGCACTCTCT
CTTGCGATAAT -> TTGCGATAATC
CTTGCGGACAG -> TTGCGGACAGT
CTTGCTATCAA -> TTGCTATCAAG
CTTGTTACAAC -> TTGTTACAACT
CTTGTTAGCCC -> TTGTTAGCCCT
CTTTACGCCTG -> TTTACGCCTGG
CTTTATCGTTA -> TTTATCGTTAA
CTTTCGTCCTG -> TTTCGTCCTGA
CTTTCTCGCCT -> TTTCTCGCCTG
CTTTGCCACCT -> TTTGCCACCTG
CTTTGCTAAAG -> TTTGCTAAAGC
CTTTTAGTACC -> TTTTAGTACCT
CTTTTGTTACG -> TTTTGTTACGA
GAAAAACGCGT -> AAAAACGCGTT
GAAAAATGCGC -> AAAAATGCGCA
GAAACATTTAA -> AAACATTTAAA
GAAAGAGATGA -> AAAGAGATGAC
GAAAGCTATCT -> AAAGCTATCTA
GAAAGTTTTTA -> AAAGTTTTTAG
GAAATAACGAC -> AAATAACGACC
GAAATACCCTC -> AAATACCCTCT
GAAATTACAGC -> AAATTACAGCG
GAAATTACCTT -> AAATTACCTTC
GAACCAGACTT -> AACCAGACTTG
GAACCCGAGCA -> AACCCGAGCAC
GAACCCGGCAC -> AACCCGGCACG
GAACCGAAGCA -> AACCGAAGCAC
GAACGGCTGTA -> AACGGCTGTAC
GAACGTTAATG -> AACGTTAATGG
GAACTATTTGC -> AACTATTTGCT
GAAGATCGGCA -> AAGATCGGCAG
GAAGCACGCCC -> AAGCACGCCCC
GAAGCGAGGTT -> AAGCGAGGTTT
GAAGCGCAAAG -> AAGCGCAAAGC
GAAGTGCAGGC -> AAGTGCAGGCC
GAAGTGCCGAT -> AAGTGCCGATC
GAAGTGCGTGA -> AAGTGCGTGAT
GAAGTGGCAGT -> AAGTGGCAGTG
GAATAAACAGC -> AATAAACAGCC
GAATAGAGCCG -> AATAGAGCCGT
GAATAGAGCTA -> AATAGAGCTAG
GAATAGCACCC -> AATAGCACCCC
GAATCGAGTTG -> AATCGAGTTGA
GAATGTACTAC -> AATGTACTACC
GAATTGCCCGA -> AATTGCCCGAT
GAATTGTCTTG -> AATTGTCTTGT
GACAACCACAA -> ACAACCACAAC
GACACGACAGG -> ACACGACAGGC
GACACGCACAG -> ACACGCACAGG
GACAGCAAGAC -> ACAGCAAGACA
GACAGGCCCCG -> ACAGGCCCCGA
GACAGTGTATG -> ACAGTGTATGT
GACATAGAATA -> ACATAGAATAG
GACATCTAGCA -> ACATCTAGCAA
GACATCTAGCC -> ACATCTAGCCA
GACATTGGAGC -> ACATTGGAGCA
GACCAAAGGCC -> ACCAAAGGCCT
GACCAACCGAG -> ACCAACCGAGC
GACCACCACGG -> ACCACCACGGC
GACCCCCGTTT -> ACCCCCGTTTG
GACCCCTTGTT -> ACCCCTTGTTA
GACCCGTGCTC -> ACCCGTGCTCC
GACCCTCACAA -> ACCCTCACAAT
GACCCTCGCAG -> ACCCTCGCAGG
GACCGACCGCC -> ACCGACCGCCG
GACCGATCGTA -> ACCGATCGTAA
GACCGCCGCCA -> ACCGCCGCCAA
GACCGGGAGGC -> ACCGGGAGGCC
GACCGTTGGTC -> ACCGTTGGTCC
GACCTCGCGCG -> ACCTCGCGCGC
GACCTTGCGAT -> ACCTTGCGATA
GACGAAACATT -> ACGAAACATTT
GACGAATAGCA -> ACGAATAGCAC
GACGACCCGTG -> ACGACCCGTGC
GACGCGATCGC -> ACGCGATCGCT
GACGGACTGAA -> ACGGACTGAAA
GACGTAGTTAA -> ACGTAGTTAAG
GACGTGGATGC -> ACGTGGATGCG
GACTAAACGCT -> ACTAAACGCTG
GACTAGATACA -> ACTAGATACAC
GACTCGCTCGA -> ACTCGCTCGAA
GACTCGGAGGG -> ACTCGGAGGGA
GACTGAAAAAT -> ACTGAAAAATG
GACTGAGGGGG -> ACTGAGGGGGT
GACTGCGCTGA -> ACTGCGCTGAC
GACTTGCGGAC -> ACTTGCGGACA
GACTTGCTATC -> ACTTGCTATCA
GAGAAGCGCAA -> AGAAGCGCAAA
GAGACCAACCG -> AGACCAACCGA
GAGACGAAACA -> AGACGAAACAT
GAGACTAGATA -> AGACTAGATAC
GAGAGATGAGA -> AGAGATGAGAC
GAGATCGGTCT -> AGATCGGTCTT
GAGATGACACG -> AGATGACACGC
GAGATGAGACG -> AGATGAGACGA
GAGATTGCGAC -> AGATTGCGACT
GAGCACAGCAT -> AGCACAGCATA
GAGCACCATGT -> AGCACCATGTC
GAGCCCGTCCG -> AGCCCGTCCGA
GAGCCGTAAAA -> AGCCGTAAAAA
GAGCGCTATCT -> AGCGCTATCTC
GAGCGGCACAT -> AGCGGCACATA
GAGCTAATCGG -> AGCTAATCGGG
GAGCTAGAATA -> AGCTAGAATAA
GAGCTTCCGCT -> AGCTTCCGCTG
GAGGAACGGCT -> AGGAACGGCTG
GAGGCCCCGGC -> AGGCCCCGGCT
GAGGGAGGGTA -> AGGGAGGGTAG
GAGGGATTCTG -> AGGGATTCTGC
GAGGGGGTTTC -> AGGGGGTTTCG
GAGGGTAGCCA -> AGGGTAGCCAC
GAGGTCTTGCA -> AGGTCTTGCAC
GAGGTCTTTAC -> AGGTCTTTACG
GAGGTTTTTTC -> AGGTTTTTTCA
GAGTCGAGGGA -> AGTCGAGGGAG
GAGTGGCACTT -> AGTGGCACTTA
GAGTTCATGGG -> AGTTCATGGGG
GAGTTGATTAT -> AGTTGATTATC
GATAACGCAGC -> ATAACGCAGCG
GATAATCCCGA -> ATAATCCCGAC
GATACACTGCC -> ATACACTGCCA
GATACCCATCC -> ATACCCATCCC
GATACGCCGAT -> ATACGCCGATA
GATACGGCCAC -> ATACGGCCACG
GATAGACGTGG -> ATAGACGTGGA
GATAGTTGATT -> ATAGTTGATTA
GATCCACTGGG -> ATCCACTGGGT
GATCCCCTAGA -> ATCCCCTAGAT
GATCCTGCGCA -> ATCCTGCGCAA
GATCGAAATTA -> ATCGAAATTAC
GATCGACGAAT -> ATCGACGAATA
GATCGACGGAC -> ATCGACGGACT
GATCGCTCGAG -> ATCGCTCGAGA
GATCGGCAGGT -> ATCGGCAGGTC
GATCGGGCACG -> ATCGGGCACGC
GATCGGTCTTT -> ATCGGTCTTTG
GATCGTAAGTG -> ATCGTAAGTGC
GATCGTGGCTA -> ATCGTGGCTAG
GATGACACGCA -> ATGACACGCAC
GATGACCCCTT -> ATGACCCCTTG
GATGAGACGAA -> ATGAGACGAAA
GATGCGCATTC -> ATGCGCATTCT
GATGCGCTAGC -> ATGCGCTAGCA
GATGCTTTTAG -> ATGCTTTTAGT
GATGGAGGAAC -> ATGGAGGAACG
GATTAACCGGC -> ATTAACCGGCG
GATTACGTGTG -> ATTACGTGTGA
GATTAGAGAGA -> ATTAGAGAGAT
GATTATCGCGT -> ATTATCGCGTC
GATTATGGGGA -> ATTATGGGGAG
GATTCTCATAT -> ATTCTCATATT
GATTCTGCTGT -> ATTCTGCTGTA
GATTGCGACTG -> ATTGCGACTGC
GATTGCGATAC -> ATTGCGATACC
GCAAAGCACTG -> CAAAGCACTGA
GCAACCCAATC -> CAACCCAATCT
GCAACTCCACA -> CAACTCCACAC
GCAAGACAACC -> CAAGACAACCA
GCAAGCGTTGA -> CAAGCGTTGAT
GCAATGGCTCC -> CAATGGCTCCC
GCAATTGGTGG -> CAATTGGTGGC
GCACAAAGGGC -> CACAAAGGGCT
GCACACCGCGG -> CACACCGCGGA
GCACAGCATAA -> CACAGCATAAC
GCACAGGGTGC -> CACAGGGTGCC
GCACAGTCTTT -> CACAGTCTTTG
GCACATAAAAT -> CACATAAAATC
GCACATCCTTC -> CACATCCTTCC
GCACCATGTCG -> CACCATGTCGC
GCACCCCGGAA -> CACCCCGGAAC
GCACGACCCTC -> CACGACCCTCG
GCACGCAGTAG -> CACGCAGTAGA
GCACGCCCCAC -> CACGCCCCACG
GCACTCTCTAC -> CACTCTCTACT
GCACTGAACGT -> CACTGAACGTT
GCACTTAGGAC -> CACTTAGGACT
GCAGATAGACG -> CAGATAGACGT
GCAGCGATGGA -> CAGCGATGGAG
GCAGGCCGAAG -> CAGGCCGAAGC
GCAGGGGCTCA -> CAGGGGCTCAT
GCAGGTCTAGG -> CAGGTCTAGGT
GCAGTAGAAGT -> CAGTAGAAGTG
GCAGTGATTAC -> CAGTGATTACG
GCATAACCAGA -> CATAACCAGAC
GCATCGTTTTC -> CATCGTTTTCG
GCATTCTAAGT -> CATTCTAAGTG
GCCAAGACCCT -> CCAAGACCCTC
GCCACCTCAGC -> CCACCTCAGCG
GCCACCTGCCC -> CCACCTGCCCA
GCCACGAACCC -> CCACGAACCCG
GCCACTGCAGA -> CCACTGCAGAT
GCCACTTTCGT -> CCACTTTCGTC
GCCAGTCCTAG -> CCAGTCCTAGA
GCCCAATGCCC -> CCCAATGCCCC
GCCCACCACTT -> CCCACCACTTC
GCCCCAAAGTA -> CCCCAAAGTAA
GCCCCACGACC -> CCCCACGACCG
GCCCCAGCGGG -> CCCCAGCGGGC
GCCCCGAATCG -> CCCCGAATCGA
GCCCCGGCTAT -> CCCCGGCTATC
GCCCGAAAGAG -> CCCGAAAGAGA
GCCCGATCCTG -> CCCGATCCTGC
GCCCGTCCGAA -> CCCGTCCGAAT
GCCCGTGTTCA -> CCCGTGTTCAA
GCCCTGATTGC -> CCCTGATTGCG
GCCCTTCTAGA -> CCCTTCTAGAC
GCCGAAGCGAG -> CCGAAGCGAGG
GCCGATAACGC -> CCGATAACGCA
GCCGATCCACT -> CCGATCCACTG
GCCGCCAAGAC -> CCGCCAAGACC
GCCGGCACACC -> CCGGCACACCG
GCCGTAAAAAG -> CCGTAAAAAGA
GCCGTAACCGT -> CCGTAACCGTT
GCCGTAACTAG -> CCGTAACTAGA
GCCGTCTTTCT -> CCGTCTTTCTC
GCCTACCCATA -> CCTACCCATAA
GCCTGACTGAG -> CCTGACTGAGG
GCCTGGTATCA -> CCTGGTATCAA
GCCTGGTATGT -> CCTGGTATGTA
GCCTGTGAAGA -> CCTGTGAAGAT
GCCTGTTAAAG -> CCTGTTAAAGA
GCGAAATAACG -> CGAAATAACGA
GCGACCCCCGT -> CGACCCCCGTT
GCGACTGCGCT -> CGACTGCGCTG
GCGAGGTTTTT -> CGAGGTTTTTT
GCGAGTGGCAC -> CGAGTGGCACT
GCGATAATCCC -> CGATAATCCCG
GCGATACCCAT -> CGATACCCATC
GCGATCGCTCG -> CGATCGCTCGA
GCGATCGGGCA -> CGATCGGGCAC
GCGATGGAGGA -> CGATGGAGGAA
GCGCAAAGCAC -> CGCAAAGCACT
GCGCAACCCAA -> CGCAACCCAAT
GCGCAAGCGTT -> CGCAAGCGTTG
GCGCATTCTAA -> CGCATTCTAAG
GCGCCTGTGAA -> CGCCTGTGAAG
GCGCGCGGTCC -> CGCGCGGTCCT
GCGCGGTCCTA -> CGCGGTCCTAG
GCGCTAGCACA -> CGCTAGCACAA
GCGCTATCTCT -> CGCTATCTCTG
GCGCTGACGCG -> CGCTGACGCGA
GCGGACAGTGT -> CGGACAGTGTA
GCGGACCGGGA -> CGGACCGGGAG
GCGGCACATAA -> CGGCACATAAA
GCGGCCTACCC -> CGGCCTACCCA
GCGGGCCTGGT -> CGGGCCTGGTA
GCGGTCCTAGA -> CGGTCCTAGAC
GCGTCCCACTG -> CGTCCCACTGC
GCGTCCGAAAT -> CGTCCGAAATT
GCGTGAACTAT -> CGTGAACTATT
GCGTGATTCTC -> CGTGATTCTCA
GCGTGTATGGG -> CGTGTATGGGC
GCGTTGAAAAA -> CGTTGAAAAAC
GCGTTGATTAA -> CGTTGATTAAC
GCGTTTGTTCG -> CGTTTGTTCGC
GCTAAAGCCCT -> CTAAAGCCCTT
GCTAAGGGAAG -> CTAAGGGAAGT
GCTAATCGGGA -> CTAATCGGGAA
GCTACATGTAG -> CTACATGTAGG
GCTACCCCTAA -> CTACCCCTAAC
GCTAGAATAAA -> CTAGAATAAAC
GCTAGAGCTTC -> CTAGAGCTTCC
GCTAGCACAAA -> CTAGCACAAAG
GCTATCAAGAT -> CTATCAAGATA
GCTATCTAACG -> CTATCTAACGG
GCTATCTCCTT -> CTATCTCCTTT
GCTATCTCTGG -> CTATCTCTGGG
GCTATTGCATC -> CTATTGCATCG
GCTCAGTAGCG -> CTCAGTAGCGT
GCTCATCAGAT -> CTCATCAGATC
GCTCCCAATAC -> CTCCCAATACA
GCTCCCAGTGA -> CTCCCAGTGAT
GCTCCCCACGA -> CTCCCCACGAG
GCTCGAACCAG -> CTCGAACCAGA
GCTCGAGAAGC -> CTCGAGAAGCG
GCTCGCCGTCT -> CTCGCCGTCTT
GCTCGGGATGC -> CTCGGGATGCG
GCTGAAAGCTA -> CTGAAAGCTAT
GCTGACGCGAT -> CTGACGCGATC
GCTGATAGTTG -> CTGATAGTTGA
GCTGCCGGCAC -> CTGCCGGCACA
GCTGTACCGAA -> CTGTACCGAAT
GCTGTATACGC -> CTGTATACGCT
GCTTAATTCTC -> CTTAATTCTCT
GCTTAGGAGCC -> CTTAGGAGCCC
GCTTATATGGC -> CTTATATGGCG
GCTTCCGCTGC -> CTTCCGCTGCC
GCTTTTAGTAC -> CTTTTAGTACC
GGAAAGTTTTT -> GAAAGTTTTTA
GGAACCCGGCA -> GAACCCGGCAC
GGAACGGCTGT -> GAACGGCTGTA
GGAAGTGCCGA -> GAAGTGCCGAT
GGAATTGCCCG -> GAATTGCCCGA
GGACAGTGTAT -> GACAGTGTATG
GGACCACCACG -> GACCACCACGG
GGACCGACCGC -> GACCGACCGCC
GGACCGGGAGG -> GACCGGGAGGC
GGACTCGCTCG -> GACTCGCTCGA
GGACTGAAAAA -> GACTGAAAAAT
GGAGACCAACC -> GAGACCAACCG
GGAGATTGCGA -> GAGATTGCGAC
GGAGCACCATG -> GAGCACCATGT
GGAGCCCGTCC -> GAGCCCGTCCG
GGAGCGGCACA -> GAGCGGCACAT
GGAGGAACGGC -> GAGGAACGGCT
GGAGGCCCCGG -> GAGGCCCCGGC
GGAGGGATTCT -> GAGGGATTCTG
GGAGGGTAGCC -> GAGGGTAGCCA
GGAGTCGAGGG -> GAGTCGAGGGA
GGATCCCCTAG -> GATCCCCTAGA
GGATCGACGAA -> GATCGACGAAT
GGATCGACGGA -> GATCGACGGAC
GGATGCGCATT -> GATGCGCATTC
GGATGCGCTAG -> GATGCGCTAGC
GGATTCTGCTG -> GATTCTGCTGT
GGCAACTCCAC -> GCAACTCCACA
GGCACACCGCG -> GCACACCGCGG
GGCACATAAAA -> GCACATAAAAT
GGCACGACCCT -> GCACGACCCTC
GGCACGCAGTA -> GCACGCAGTAG
GGCACTTAGGA -> GCACTTAGGAC
GGCAGGTCTAG -> GCAGGTCTAGG
GGCAGTGATTA -> GCAGTGATTAC
GGCCACGAACC -> GCCACGAACCC
GGCCAGTCCTA -> GCCAGTCCTAG
GGCCCCGAATC -> GCCCCGAATCG
GGCCCCGGCTA -> GCCCCGGCTAT
GGCCCGTGTTC -> GCCCGTGTTCA
GGCCGAAGCGA -> GCCGAAGCGAG
GGCCGTAACCG -> GCCGTAACCGT
GGCCTACCCAT -> GCCTACCCATA
GGCCTGGTATG -> GCCTGGTATGT
GGCCTGTTAAA -> GCCTGTTAAAG
GGCGAAATAAC -> GCGAAATAACG
GGCGACCCCCG -> GCGACCCCCGT
GGCGAGTGGCA -> GCGAGTGGCAC
GGCGATCGGGC -> GCGATCGGGCA
GGCGTCCGAAA -> GCGTCCGAAAT
GGCTACATGTA -> GCTACATGTAG
GGCTAGAGCTT -> GCTAGAGCTTC
GGCTATCTCCT -> GCTATCTCCTT
GGCTCATCAGA -> GCTCATCAGAT
GGCTCCCAATA -> GCTCCCAATAC
GGCTCCCCACG -> GCTCCCCACGA
GGCTCGCCGTC -> GCTCGCCGTCT
GGCTCGGGATG -> GCTCGGGATGC
GGCTGTACCGA -> GCTGTACCGAA
GGCTTAATTCT -> GCTTAATTCTC
GGGAAAGTTTT -> GGAAAGTTTTT
GGGAAGTGCCG -> GGAAGTGCCGA
GGGAATTGCCC -> GGAATTGCCCG
GGGAGCGGCAC -> GGAGCGGCACA
GGGAGGCCCCG -> GGAGGCCCCGG
GGGAGGGTAGC -> GGAGGGTAGCC
GGGAGTCGAGG -> GGAGTCGAGGG
GGGATGCGCAT -> GGATGCGCATT
GGGATTCTGCT -> GGATTCTGCTG
GGGCAACTCCA -> GGCAACTCCAC
GGGCACGCAGT -> GGCACGCAGTA
GGGCCCGTGTT -> GGCCCGTGTTC
GGGCCTGGTAT -> GGCCTGGTATG
GGGCGAGTGGC -> GGCGAGTGGCA
GGGCTCATCAG -> GGCTCATCAGA
GGGCTTAATTC -> GGCTTAATTCT
GGGGAGTCGAG -> GGGAGTCGAGG
GGGGCTCATCA -> GGGCTCATCAG
GGGGGTTTCGA -> GGGGTTTCGAC
GGGGTGCGTGA -> GGGTGCGTGAA
GGGGTTTCGAC -> GGGTTTCGACT
GGGTAGCCACT -> GGTAGCCACTT
GGGTCCTCAGT -> GGTCCTCAGTC
GGGTCGGTTAT -> GGTCGGTTATA
GGGTGCCACTG -> GGTGCCACTGC
GGGTGCGTGAA -> GGTGCGTGAAC
GGGTGGAGACC -> GGTGGAGACCA
GGGTTACACGG -> GGTTACACGGG
GGGTTTCGACT -> GGTTTCGACTA
GGTAGCCACTT -> GTAGCCACTTT
GGTATAGTATC -> GTATAGTATCC
GGTATCAAGGC -> GTATCAAGGCT
GGTATGTAAAG -> GTATGTAAAGG
GGTCCCGGAGA -> GTCCCGGAGAT
GGTCCTAGACA -> GTCCTAGACAG
GGTCCTCAGTC -> GTCCTCAGTCT
GGTCGAACCGA -> GTCGAACCGAA
GGTCGGTTATA -> GTCGGTTATAC
GGTCTAGGTGG -> GTCTAGGTGGG
GGTCTTGCACT -> GTCTTGCACTC
GGTCTTTACGC -> GTCTTTACGCC
GGTCTTTGCCA -> GTCTTTGCCAC
GGTGACACGAC -> GTGACACGACA
GGTGCCACTGC -> GTGCCACTGCA
GGTGCGTGAAC -> GTGCGTGAACT
GGTGGAGACCA -> GTGGAGACCAA
GGTGGCTCGCC -> GTGGCTCGCCG
GGTGGGAGCGG -> GTGGGAGCGGC
GGTTACACGGG -> GTTACACGGGA
GGTTATACCCG -> GTTATACCCGA
GGTTCCCGACC -> GTTCCCGACCA
GGTTTCGACTA -> GTTTCGACTAA
GGTTTTTTCAT -> GTTTTTTCATG
GTAAAAAGAAG -> TAAAAAGAAGT
GTAAAACATGT -> TAAAACATGTA
GTAAAGGCCGT -> TAAAGGCCGTA
GTAACCAAGTT -> TAACCAAGTTA
GTAACCGTTTA -> TAACCGTTTAA
GTAACTAGACG -> TAACTAGACGT
GTAACTCATAC -> TAACTCATACC
GTAAGTGCTAT -> TAAGTGCTATT
GTACCGAATGT -> TACCGAATGTA
GTACCTACGGT -> TACCTACGGTG
GTACGGGTGGA -> TACGGGTGGAG
GTACTACCCGC -> TACTACCCGCT
GTAGAAGTGCA -> TAGAAGTGCAG
GTAGCCACTTT -> TAGCCACTTTC
GTAGCGTGTAT -> TAGCGTGTATG
GTAGGATCGAC -> TAGGATCGACG
GTAGTTAAGCA -> TAGTTAAGCAC
GTATACGCTGA -> TATACGCTGAT
GTATAGTATCC -> TATAGTATCCG
GTATCAAGGCT -> TATCAAGGCTC
GTATCCGCGCC -> TATCCGCGCCT
GTATGGGCGAG -> TATGGGCGAGT
GTATGTAAAGG -> TATGTAAAGGC
GTATGTTTCGT -> TATGTTTCGTG
GTCCCACTGCC -> TCCCACTGCCC
GTCCCATAGTG -> TCCCATAGTGG
GTCCCGGAGAT -> TCCCGGAGATT
GTCCGAAATTA -> TCCGAAATTAC
GTCCGAATTGT -> TCCGAATTGTC
GTCCTAGACAG -> TCCTAGACAGC
GTCCTAGAGAT -> TCCTAGAGATC
GTCCTCAGTCT -> TCCTCAGTCTT
GTCCTGAGACT -> TCCTGAGACTA
GTCGAACCGAA -> TCGAACCGAAG
GTCGAGGGAGG -> TCGAGGGAGGG
GTCGCAATTGG -> TCGCAATTGGT
GTCGCACAGTC -> TCGCACAGTCT
GTCGGTTATAC -> TCGGTTATACC
GTCTAGGTGGG -> TCTAGGTGGGA
GTCTTGCACTC -> TCTTGCACTCT
GTCTTGTTACA -> TCTTGTTACAA
GTCTTTACGCC -> TCTTTACGCCT
GTCTTTATCGT -> TCTTTATCGTT
GTCTTTCTCGC -> TCTTTCTCGCC
GTCTTTGCCAC -> TCTTTGCCACC
GTCTTTGCTAA -> TCTTTGCTAAA
GTGAAATACCC -> TGAAATACCCT
GTGAACTATTT -> TGAACTATTTG
GTGAAGATCGG -> TGAAGATCGGC
GTGACACGACA -> TGACACGACAG
GTGAGGTCTTG -> TGAGGTCTTGC
GTGATCGTGGC -> TGATCGTGGCT
GTGATTACGTG -> TGATTACGTGT
GTGATTCTCAT -> TGATTCTCATA
GTGCAGGCCGA -> TGCAGGCCGAA
GTGCCACTGCA -> TGCCACTGCAG
GTGCCGATCCA -> TGCCGATCCAC
GTGCGTGAACT -> TGCGTGAACTA
GTGCGTGATTC -> TGCGTGATTCT
GTGCTATTGCA -> TGCTATTGCAT
GTGCTCCCAGT -> TGCTCCCAGTG
GTGGAGACCAA -> TGGAGACCAAC
GTGGATGCGCT -> TGGATGCGCTA
GTGGCACTTAG -> TGGCACTTAGG
GTGGCAGTGAT -> TGGCAGTGATT
GTGGCGAAATA -> TGGCGAAATAA
GTGGCTAGAGC -> TGGCTAGAGCT
GTGGCTCGCCG -> TGGCTCGCCGT
GTGGGAGCGGC -> TGGGAGCGGCA
GTGGTATAGTA -> TGGTATAGTAT
GTGGTTCCCGA -> TGGTTCCCGAC
GTGTATGGGCG -> TGTATGGGCGA
GTGTATGTTTC -> TGTATGTTTCG
GTGTCCCATAG -> TGTCCCATAGT
GTGTGAGGTCT -> TGTGAGGTCTT
GTGTGTCCCAT -> TGTGTCCCATA
GTGTTCAATGC -> TGTTCAATGCC
GTTAAAGAAGT -> TTAAAGAAGTG
GTTAAGCACAT -> TTAAGCACATC
GTTAATATGTT -> TTAATATGTTT
GTTAATGGCTC -> TTAATGGCTCC
GTTAATGGGTC -> TTAATGGGTCC
GTTACAACTAG -> TTACAACTAGA
GTTACACGGGA -> TTACACGGGAA
GTTACGAATAG -> TTACGAATAGA
GTTAGCCCTGA -> TTAGCCCTGAT
GTTATACCCGA -> TTATACCCGAC
GTTCAATGCCC -> TTCAATGCCCA
GTTCATGGGGT -> TTCATGGGGTG
GTTCCAGTGGT -> TTCCAGTGGTA
GTTCCCGACCA -> TTCCCGACCAA
GTTCGCTCAGT -> TTCGCTCAGTA
GTTGAAAAACG -> TTGAAAAACGC
GTTGATTAACC -> TTGATTAACCG
GTTGATTATCG -> TTGATTATCGC
GTTGATTATGG -> TTGATTATGGG
GTTGGTCCCGG -> TTGGTCCCGGA
GTTTAATTTCG -> TTTAATTTCGT
GTTTCGACTAA -> TTTCGACTAAA
GTTTCGTGGTT -> TTTCGTGGTTC
GTTTGACGACC -> TTTGACGACCC
GTTTGAGTTCA -> TTTGAGTTCAT
GTTTGTTCGCT -> TTTGTTCGCTC
GTTTTCGGGCC -> TTTTCGGGCCC
GTTTTTAGGAT -> TTTTTAGGATC
GTTTTTTCATG -> TTTTTTCATGG
TAAAAAGAAGT -> AAAAAGAAGTG
TAAAACATGTA -> AAAACATGTAA
TAAAATCCGAC -> AAAATCCGACT
TAAAATCGATA -> AAAATCGATAC
TAAACAGCCCG -> AAACAGCCCGA
TAAACGCTGAA -> AAACGCTGAAA
TAAAGAAGTGG -> AAAGAAGTGGC
TAAAGCCCTTC -> AAAGCCCTTCT
TAAAGGCCGTA -> AAAGGCCGTAA
TAAAGTTCCAG -> AAAGTTCCAGT
TAACCAAGTTA -> AACCAAGTTAA
TAACCAGACCT -> AACCAGACCTT
TAACCGGCGTC -> AACCGGCGTCC
TAACCGTTTAA -> AACCGTTTAAT
TAACGACATCT -> AACGACATCTA
TAACGACCGAT -> AACGACCGATC
TAACGCAGCGA -> AACGCAGCGAT
TAACGGATCCC -> AACGGATCCCC
TAACTAGACGT -> AACTAGACGTA
TAACTCATACC -> AACTCATACCC
TAAGCACATCC -> AAGCACATCCT
TAAGGGAAGTG -> AAGGGAAGTGC
TAAGTGAAATA -> AAGTGAAATAC
TAAGTGCTATT -> AAGTGCTATTG
TAATATGTTTG -> AATATGTTTGA
TAATCCCGACA -> AATCCCGACAT
TAATCGACTCG -> AATCGACTCGG
TAATCGGGAAA -> AATCGGGAAAG
TAATGGCTCCC -> AATGGCTCCCC
TAATGGGTCCT -> AATGGGTCCTC
TAATTCTCTCA -> AATTCTCTCAG
TAATTTCGTAC -> AATTTCGTACG
TACAACTAGAT -> ACAACTAGATG
TACACACAAAT -> ACACACAAATT
TACACGGGAAT -> ACACGGGAATT
TACACTGCCAT -> ACACTGCCATT
TACAGCGTTGA -> ACAGCGTTGAA
TACATGTAGGA -> ACATGTAGGAT
TACATTATTAG -> ACATTATTAGG
TACCCAATAAA -> ACCCAATAAAA
TACCCATAATC -> ACCCATAATCG
TACCCATCCCG -> ACCCATCCCGA
TACCCCTAACG -> ACCCCTAACGA
TACCCGACATC -> ACCCGACATCT
TACCCGCTAAG -> ACCCGCTAAGG
TACCCTCTCCC -> ACCCTCTCCCG
TACCGAATGTA -> ACCGAATGTAC
TACCGAGCGCT -> ACCGAGCGCTA
TACCTACGGTG -> ACCTACGGTGA
TACCTTACCGA -> ACCTTACCGAG
TACCTTCGGCG -> ACCTTCGGCGA
TACGAATAGAG -> ACGAATAGAGC
TACGCCGATAA -> ACGCCGATAAC
TACGCCTGGTA -> ACGCCTGGTAT
TACGCTGATAG -> ACGCTGATAGT
TACGGCCACGA -> ACGGCCACGAA
TACGGGTGGAG -> ACGGGTGGAGA
TACGGTGACAC -> ACGGTGACACG
TACGTGTGAGG -> ACGTGTGAGGT
TACTACCCGCT -> ACTACCCGCTA
TACTAGATGCT -> ACTAGATGCTT
TAGAAGTGCAG -> AGAAGTGCAGG
TAGAATAAACA -> AGAATAAACAG
TAGAATAGAGC -> AGAATAGAGCC
TAGACAGCAAG -> AGACAGCAAGA
TAGACCTCGCG -> AGACCTCGCGC
TAGACGTAGTT -> AGACGTAGTTA
TAGACGTGGAT -> AGACGTGGATG
TAGAGAGATGA -> AGAGAGATGAG
TAGAGATCGGT -> AGAGATCGGTC
TAGAGCCGTAA -> AGAGCCGTAAA
TAGAGCTAGAA -> AGAGCTAGAAT
TAGAGCTTCCG -> AGAGCTTCCGC
TAGATACACTG -> AGATACACTGC
TAGATGACCCC -> AGATGACCCCT
TAGATGCTTTT -> AGATGCTTTTA
TAGATTAGAGA -> AGATTAGAGAG
TAGCAATGGCT -> AGCAATGGCTC
TAGCACAAAGG -> AGCACAAAGGG
TAGCACCCCGG -> AGCACCCCGGA
TAGCCACCTCA -> AGCCACCTCAG
TAGCCACTTTC -> AGCCACTTTCG
TAGCCCTGATT -> AGCCCTGATTG
TAGCGTGTATG -> AGCGTGTATGG
TAGGACTCGCT -> AGGACTCGCTC
TAGGAGCCCGT -> AGGAGCCCGTC
TAGGATCGACG -> AGGATCGACGA,AGGATCGACGG
TAGGCCAGTCC -> AGGCCAGTCCT
TAGGTGGGAGC -> AGGTGGGAGCG
TAGTACCTACG -> AGTACCTACGG
TAGTATCCGCG -> AGTATCCGCGC
TAGTGGCGAAA -> AGTGGCGAAAT
TAGTTAAGCAC -> AGTTAAGCACA
TAGTTGATTAT -> AGTTGATTATG
TATACCCGACA -> ATACCCGACAT
TATACGCTGAT -> ATACGCTGATA
TATAGTATCCG -> ATAGTATCCGC
TATATGGCGAT -> ATATGGCGATC
TATCAAGATAC -> ATCAAGATACG
TATCAAGGCTC -> ATCAAGGCTCG
TATCACTTATG -> ATCACTTATGG
TATCCGCGCCT -> ATCCGCGCCTG
TATCGCGTCCC -> ATCGCGTCCCA
TATCGTTAATG -> ATCGTTAATGG
TATCTAACGGA -> ATCTAACGGAT
TATCTCCTTTT -> ATCTCCTTTTG
TATCTCTGGGC -> ATCTCTGGGCA
TATGGACCACC -> ATGGACCACCA
TATGGCGATCG -> ATGGCGATCGG
TATGGGCGAGT -> ATGGGCGAGTG
TATGGGGAGTC -> ATGGGGAGTCG
TATGTAAAACA -> ATGTAAAACAT
TATGTAAAGGC -> ATGTAAAGGCC
TATGTTTCGTG -> ATGTTTCGTGG
TATGTTTGAGT -> ATGTTTGAGTT
TATTAGGCCAG -> ATTAGGCCAGT
TATTCACTTCT -> ATTCACTTCTG
TATTGCATCGT -> ATTGCATCGTT
TATTTGCTTAG -> ATTTGCTTAGG
TCAAGATACGG -> CAAGATACGGC
TCAAGGCTCGG -> CAAGGCTCGGG
TCAATGCCCAA -> CAATGCCCAAT
TCACAATTACA -> CACAATTACAC
TCACTTATGGA -> CACTTATGGAC
TCACTTCTGCC -> CACTTCTGCCG
TCAGATCGAAA -> CAGATCGAAAT
TCAGCGGCCTA -> CAGCGGCCTAC
TCAGGGTTACA -> CAGGGTTACAC
TCAGTAGCGTG -> CAGTAGCGTGT
TCAGTCTTTAT -> CAGTCTTTATC
TCATACCCAAT -> CATACCCAATA
TCATATTCACT -> CATATTCACTT
TCATCAGATCG -> CATCAGATCGA
TCATGGGGTGC -> CATGGGGTGCG
TCATGGTCGAA -> CATGGTCGAAC
TCCACACATTG -> CCACACATTGG
TCCACTGGGTC -> CCACTGGGTCG
TCCAGTGGTAT -> CCAGTGGTATA
TCCCAATACAT -> CCCAATACATT
TCCCACTGCCC -> CCCACTGCCCC
TCCCAGTGATC -> CCCAGTGATCG
TCCCATAGTGG -> CCCATAGTGGC
TCCCCACGAGG -> CCCCACGAGGT
TCCCCTAGATT -> CCCCTAGATTA
TCCCGACATAG -> CCCGACATAGA
TCCCGACATTG -> CCCGACATTGG
TCCCGACCAAA -> CCCGACCAAAG
TCCCGGAGATT -> CCCGGAGATTG
TCCCGTCGCAA -> CCCGTCGCAAT
TCCGAAATTAC -> CCGAAATTACA
TCCGAATTGTC -> CCGAATTGTCT
TCCGACTTGCG -> CCGACTTGCGG
TCCGCGCCTGT -> CCGCGCCTGTG
TCCGCTGCCGG -> CCGCTGCCGGC
TCCGTGTGTCC -> CCGTGTGTCCC
TCCTAGACAGC -> CCTAGACAGCA
TCCTAGAGATC -> CCTAGAGATCG
TCCTATGTAAA -> CCTATGTAAAA
TCCTCAGTCTT -> CCTCAGTCTTT
TCCTGAGACTA -> CCTGAGACTAG
TCCTGCGCAAC -> CCTGCGCAACC
TCCTTCCTATG -> CCTTCCTATGT
TCCTTTTGTTA -> CCTTTTGTTAC
TCGAAATTACC -> CGAAATTACCT
TCGAACCAGAC -> CGAACCAGACT
TCGAACCGAAG -> CGAACCGAAGC
TCGACGAATAG -> CGACGAATAGC
TCGACGGACTG -> CGACGGACTGA
TCGACTAAACG -> CGACTAAACGC
TCGACTCGGAG -> CGACTCGGAGG
TCGAGAAGCGC -> CGAGAAGCGCA
TCGAGGGAGGG -> CGAGGGAGGGT
TCGAGTTGATT -> CGAGTTGATTA
TCGATACGCCG -> CGATACGCCGA
TCGCAATTGGT -> CGCAATTGGTG
TCGCACAGTCT -> CGCACAGTCTT
TCGCAGGGGCT -> CGCAGGGGCTC
TCGCCGTCTTT -> CGCCGTCTTTC
TCGCCTGACTG -> CGCCTGACTGA
TCGCGCGCGGT -> CGCGCGCGGTC
TCGCGTCCCAC -> CGCGTCCCACT
TCGCTCAGTAG -> CGCTCAGTAGC
TCGCTCGAACC -> CGCTCGAACCA
TCGCTCGAGAA -> CGCTCGAGAAG
TCGCTTATATG -> CGCTTATATGG
TCGGAGGGATT -> CGGAGGGATTC
TCGGCAGGTCT -> CGGCAGGTCTA
TCGGCGACCCC -> CGGCGACCCCC
TCGGGAAAGTT -> CGGGAAAGTTT
TCGGGATGCGC -> CGGGATGCGCA
TCGGGCACGCA -> CGGGCACGCAG
TCGGGCCCGTG -> CGGGCCCGTGT
TCGGTCTTTGC -> CGGTCTTTGCC
TCGGTTATACC -> CGGTTATACCC
TCGTAAGTGCT -> CGTAAGTGCTA
TCGTACGGGTG -> CGTACGGGTGG
TCGTCCTGAGA -> CGTCCTGAGAC
TCGTGGCTAGA -> CGTGGCTAGAG
TCGTGGTTCCC -> CGTGGTTCCCG
TCGTTAATGGC -> CGTTAATGGCT
TCGTTTTCGGG -> CGTTTTCGGGC
TCTAACGGATC -> CTAACGGATCC
TCTAAGTGAAA -> CTAAGTGAAAT
TCTACCTTACC -> CTACCTTACCG
TCTACTAGATG -> CTACTAGATGC
TCTAGACCTCG -> CTAGACCTCGC
TCTAGCAATGG -> CTAGCAATGGC
TCTAGCCACCT -> CTAGCCACCTC
TCTAGGTGGGA -> CTAGGTGGGAG
TCTCAGGGTTA -> CTCAGGGTTAC
TCTCATATTCA -> CTCATATTCAC
TCTCCCGTCGC -> CTCCCGTCGCA
TCTCCTTTTGT -> CTCCTTTTGTT
TCTCGCCTGAC -> CTCGCCTGACT
TCTCTACTAGA -> CTCTACTAGAT
TCTCTCAGGGT -> CTCTCAGGGTT
TCTCTGGGCAA -> CTCTGGGCAAC
TCTGCCGTAAC -> CTGCCGTAACT
TCTGCTGTATA -> CTGCTGTATAC
TCTGGGCAACT -> CTGGGCAACTC
TCTTGCACTCT -> CTTGCACTCTC
TCTTGTTACAA -> CTTGTTACAAC
TCTTTACGCCT -> CTTTACGCCTG
TCTTTATCGTT -> CTTTATCGTTA
TCTTTCTCGCC -> CTTTCTCGCCT
TCTTTGCCACC -> CTTTGCCACCT
TCTTTGCTAAA -> CTTTGCTAAAG
TGAAAAACGCG -> GAAAAACGCGT
TGAAAAATGCG -> GAAAAATGCGC
TGAAAGCTATC -> GAAAGCTATCT
TGAAATACCCT -> GAAATACCCTC
TGAACGTTAAT -> GAACGTTAATG
TGAACTATTTG -> GAACTATTTGC
TGAAGATCGGC -> GAAGATCGGCA
TGACACGACAG -> GACACGACAGG
TGACACGCACA -> GACACGCACAG
TGACCCCTTGT -> GACCCCTTGTT
TGACGACCCGT -> GACGACCCGTG
TGACGCGATCG -> GACGCGATCGC
TGACTGAGGGG -> GACTGAGGGGG
TGAGACGAAAC -> GAGACGAAACA
TGAGACTAGAT -> GAGACTAGATA
TGAGGGGGTTT -> GAGGGGGTTTC
TGAGGTCTTGC -> GAGGTCTTGCA
TGAGTTCATGG -> GAGTTCATGGG
TGATAGTTGAT -> GATAGTTGATT
TGATCGTGGCT -> GATCGTGGCTA
TGATTAACCGG -> GATTAACCGGC
TGATTACGTGT -> GATTACGTGTG
TGATTATCGCG -> GATTATCGCGT
TGATTATGGGG -> GATTATGGGGA
TGATTCTCATA -> GATTCTCATAT
TGATTGCGATA -> GATTGCGATAC
TGCACTCTCTA -> GCACTCTCTAC
TGCAGATAGAC -> GCAGATAGACG
TGCAGGCCGAA -> GCAGGCCGAAG
TGCATCGTTTT -> GCATCGTTTTC
TGCCACCTGCC -> GCCACCTGCCC
TGCCACTGCAG -> GCCACTGCAGA
TGCCCAATGCC -> GCCCAATGCCC
TGCCCACCACT -> GCCCACCACTT
TGCCCCAAAGT -> GCCCCAAAGTA
TGCCCCAGCGG -> GCCCCAGCGGG
TGCCCGATCCT -> GCCCGATCCTG
TGCCGATCCAC -> GCCGATCCACT
TGCCGGCACAC -> GCCGGCACACC
TGCCGTAACTA -> GCCGTAACTAG
TGCGACTGCGC -> GCGACTGCGCT
TGCGATAATCC -> GCGATAATCCC
TGCGATACCCA -> GCGATACCCAT
TGCGCAACCCA -> GCGCAACCCAA
TGCGCAAGCGT -> GCGCAAGCGTT
TGCGCATTCTA -> GCGCATTCTAA
TGCGCTAGCAC -> GCGCTAGCACA
TGCGCTGACGC -> GCGCTGACGCG
TGCGGACAGTG -> GCGGACAGTGT
TGCGTGAACTA -> GCGTGAACTAT
TGCGTGATTCT -> GCGTGATTCTC
TGCTAAAGCCC -> GCTAAAGCCCT
TGCTATCAAGA -> GCTATCAAGAT
TGCTATTGCAT -> GCTATTGCATC
TGCTCCCAGTG -> GCTCCCAGTGA
TGCTGTATACG -> GCTGTATACGC
TGCTTAGGAGC -> GCTTAGGAGCC
TGCTTTTAGTA -> GCTTTTAGTAC
TGGACCACCAC -> GGACCACCACG
TGGACCGACCG -> GGACCGACCGC
TGGAGACCAAC -> GGAGACCAACC
TGGAGCACCAT -> GGAGCACCATG
TGGAGGAACGG -> GGAGGAACGGC
TGGATGCGCTA -> GGATGCGCTAG
TGGCACTTAGG -> GGCACTTAGGA
TGGCAGTGATT -> GGCAGTGATTA
TGGCGAAATAA -> GGCGAAATAAC
TGGCGATCGGG -> GGCGATCGGGC
TGGCTAGAGCT -> GGCTAGAGCTT
TGGCTCCCAAT -> GGCTCCCAATA
TGGCTCCCCAC -> GGCTCCCCACG
TGGCTCGCCGT -> GGCTCGCCGTC
TGGGAGCGGCA -> GGGAGCGGCAC
TGGGCAACTCC -> GGGCAACTCCA
TGGGCGAGTGG -> GGGCGAGTGGC
TGGGGAGTCGA -> GGGGAGTCGAG
TGGGGTGCGTG -> GGGGTGCGTGA
TGGGTCCTCAG -> GGGTCCTCAGT
TGGGTCGGTTA -> GGGTCGGTTAT
TGGTATAGTAT -> GGTATAGTATC
TGGTATCAAGG -> GGTATCAAGGC
TGGTATGTAAA -> GGTATGTAAAG
TGGTCCCGGAG -> GGTCCCGGAGA
TGGTCGAACCG -> GGTCGAACCGA
TGGTGGCTCGC -> GGTGGCTCGCC
TGGTTCCCGAC -> GGTTCCCGACC
TGTAAAACATG -> GTAAAACATGT
TGTAAAGGCCG -> GTAAAGGCCGT
TGTAACTCATA -> GTAACTCATAC
TGTACCGAATG -> GTACCGAATGT
TGTACTACCCG -> GTACTACCCGC
TGTAGGATCGA -> GTAGGATCGAC
TGTATACGCTG -> GTATACGCTGA
TGTATGGGCGA -> GTATGGGCGAG
TGTATGTTTCG -> GTATGTTTCGT
TGTCCCATAGT -> GTCCCATAGTG
TGTCGCACAGT -> GTCGCACAGTC
TGTCTTGTTAC -> GTCTTGTTACA
TGTGAAGATCG -> GTGAAGATCGG
TGTGAGGTCTT -> GTGAGGTCTTG
TGTGTCCCATA -> GTGTCCCATAG
TGTTAAAGAAG -> GTTAAAGAAGT
TGTTACAACTA -> GTTACAACTAG
TGTTACGAATA -> GTTACGAATAG
TGTTAGCCCTG -> GTTAGCCCTGA
TGTTCAATGCC -> GTTCAATGCCC
TGTTCGCTCAG -> GTTCGCTCAGT
TGTTTCGTGGT -> GTTTCGTGGTT
TGTTTGAGTTC -> GTTTGAGTTCA
TTAAAGAAGTG -> TAAAGAAGTGG
TTAAAGTTCCA -> TAAAGTTCCAG
TTAACCGGCGT -> TAACCGGCGTC
TTAAGCACATC -> TAAGCACATCC
TTAATATGTTT -> TAATATGTTTG
TTAATGGCTCC -> TAATGGCTCCC
TTAATGGGTCC -> TAATGGGTCCT
TTAATTCTCTC -> TAATTCTCTCA
TTAATTTCGTA -> TAATTTCGTAC
TTACAACTAGA -> TACAACTAGAT
TTACACACAAA -> TACACACAAAT
TTACACGGGAA -> TACACGGGAAT
TTACAGCGTTG -> TACAGCGTTGA
TTACCGAGCGC -> TACCGAGCGCT
TTACCTTCGGC -> TACCTTCGGCG
TTACGAATAGA -> TACGAATAGAG
TTACGCCTGGT -> TACGCCTGGTA
TTACGTGTGAG -> TACGTGTGAGG
TTAGAGAGATG -> TAGAGAGATGA
TTAGCCCTGAT -> TAGCCCTGATT
TTAGGACTCGC -> TAGGACTCGCT
TTAGGAGCCCG -> TAGGAGCCCGT
TTAGGATCGAC -> TAGGATCGACG
TTAGGCCAGTC -> TAGGCCAGTCC
TTAGTACCTAC -> TAGTACCTACG
TTATACCCGAC -> TATACCCGACA
TTATATGGCGA -> TATATGGCGAT
TTATCACTTAT -> TATCACTTATG
TTATCGCGTCC -> TATCGCGTCCC
TTATCGTTAAT -> TATCGTTAATG
TTATGGACCAC -> TATGGACCACC
TTATGGGGAGT -> TATGGGGAGTC
TTATTAGGCCA -> TATTAGGCCAG
TTCAATGCCCA -> TCAATGCCCAA
TTCACTTCTGC -> TCACTTCTGCC
TTCATGGGGTG -> TCATGGGGTGC
TTCATGGTCGA -> TCATGGTCGAA
TTCCAGTGGTA -> TCCAGTGGTAT
TTCCCGACCAA -> TCCCGACCAAA
TTCCGCTGCCG -> TCCGCTGCCGG
TTCCTATGTAA -> TCCTATGTAAA
TTCGACTAAAC -> TCGACTAAACG
TTCGCTCAGTA -> TCGCTCAGTAG
TTCGCTTATAT -> TCGCTTATATG
TTCGGCGACCC -> TCGGCGACCCC
TTCGGGCCCGT -> TCGGGCCCGTG
TTCGTACGGGT -> TCGTACGGGTG
TTCGTCCTGAG -> TCGTCCTGAGA
TTCGTGGTTCC -> TCGTGGTTCCC
TTCTAAGTGAA -> TCTAAGTGAAA
TTCTAGACCTC -> TCTAGACCTCG
TTCTCATATTC -> TCTCATATTCA
TTCTCGCCTGA -> TCTCGCCTGAC
TTCTCTCAGGG -> TCTCTCAGGGT
TTCTGCCGTAA -> TCTGCCGTAAC
TTCTGCTGTAT -> TCTGCTGTATA
TTGAAAAACGC -> TGAAAAACGCG
TTGACGACCCG -> TGACGACCCGT
TTGAGTTCATG -> TGAGTTCATGG
TTGATTAACCG -> TGATTAACCGG
TTGATTATCGC -> TGATTATCGCG
TTGATTATGGG -> TGATTATGGGG
TTGCACTCTCT -> TGCACTCTCTA
TTGCATCGTTT -> TGCATCGTTTT
TTGCCACCTGC -> TGCCACCTGCC
TTGCCCGATCC -> TGCCCGATCCT
TTGCGACTGCG -> TGCGACTGCGC
TTGCGATAATC -> TGCGATAATCC
TTGCGATACCC -> TGCGATACCCA
TTGCGGACAGT -> TGCGGACAGTG
TTGCTAAAGCC -> TGCTAAAGCCC
TTGCTATCAAG -> TGCTATCAAGA
TTGCTTAGGAG -> TGCTTAGGAGC
TTGGACCGACC -> TGGACCGACCG
TTGGAGCACCA -> TGGAGCACCAT
TTGGTCCCGGA -> TGGTCCCGGAG
TTGGTGGCTCG -> TGGTGGCTCGC
TTGTCTTGTTA -> TGTCTTGTTAC
TTGTTACAACT -> TGTTACAACTA
TTGTTACGAAT -> TGTTACGAATA
TTGTTAGCCCT -> TGTTAGCCCTG
TTGTTCGCTCA -> TGTTCGCTCAG
TTTAAAGTTCC -> TTAAAGTTCCA
TTTAATTTCGT -> TTAATTTCGTA
TTTACGCCTGG -> TTACGCCTGGT
TTTAGGATCGA -> TTAGGATCGAC
TTTAGTACCTA -> TTAGTACCTAC
TTTATCGTTAA -> TTATCGTTAAT
TTTCATGGTCG -> TTCATGGTCGA
TTTCGACTAAA -> TTCGACTAAAC
TTTCGGGCCCG -> TTCGGGCCCGT
TTTCGTACGGG -> TTCGTACGGGT
TTTCGTCCTGA -> TTCGTCCTGAG
TTTCGTGGTTC -> TTCGTGGTTCC
TTTCTCGCCTG -> TTCTCGCCTGA
TTTGACGACCC -> TTGACGACCCG
TTTGAGTTCAT -> TTGAGTTCATG
TTTGCCACCTG -> TTGCCACCTGC
TTTGCTAAAGC -> TTGCTAAAGCC
TTTGCTTAGGA -> TTGCTTAGGAG
TTTGTTACGAA -> TTGTTACGAAT
TTTGTTCGCTC -> TTGTTCGCTCA
TTTTAGGATCG -> TTTAGGATCGA
TTTTAGTACCT -> TTTAGTACCTA
TTTTCATGGTC -> TTTCATGGTCG
TTTTCGGGCCC -> TTTCGGGCCCG
TTTTGTTACGA -> TTTGTTACGAA
TTTTTAGGATC -> TTTTAGGATCG
TTTTTCATGGT -> TTTTCATGGTC
TTTTTTCATGG -> TTTTTCATGGT
